Constituency,O.S.N.,Candidate,Party,EVM Votes,Postal Votes,Total Votes,% of Votes
Alandur,1,T.M.Anbarasan,Dravida Munnetra Kazhagam,115777,1008,116785,49.12
Alandur,2,B.Valarmathi,All India Anna Dravida Munnetra Kazhagam,75634,580,76214,32.06
Alandur,3,N.Raja,Desiya Makkal Sakthi Katchi,261,4,265,0.11
Alandur,4,G Kamalakannan,Tamil Nadu Ilangyar Katchi,1096,9,1105,0.46
Alandur,5,Dr.R.Karthikeyan,Naam Tamilar Katchi,16453,53,16506,6.94
Alandur,6,Sarathbabu,Makkal Needhi Maiam,21045,72,21117,8.88
Alandur,7,Subashree,Anaithu Makkal Arasiyal Katchi,187,0,187,0.08
Alandur,8,Dr.R.Suresh,Bhartiya Manavadhikaar Federal Party,63,0,63,0.03
Alandur,9,M Mohammed Thameem Ansari,SOCIAL DEMOCRATIC PARTY OF INDIA,1750,11,1761,0.74
Alandur,10,Rajesh Chinnadurai,National Democratic Party of South India,54,6,60,0.03
Alandur,11,J.Vincent,Republican Party of India (Athawale),36,10,46,0.02
Alandur,12,E.Anbarasu,Independent,199,3,202,0.08
Alandur,13,S.Anbarasu,Independent,84,0,84,0.04
Alandur,14,M Anbarasu,Independent,108,0,108,0.05
Alandur,15,M.Ashok Kumar,Independent,73,1,74,0.03
Alandur,16,Ali Mohamed,Independent,219,1,220,0.09
Alandur,17,A.Abrahamlincon,Independent,260,0,260,0.11
Alandur,18,P.Sathiyaraj,Independent,140,0,140,0.06
Alandur,19,K Saravanan,Independent,40,0,40,0.02
Alandur,20,C Saravanan,Independent,39,1,40,0.02
Alandur,21,S.V.Saravanan,Independent,56,0,56,0.02
Alandur,22,Nithyanandham S,Independent,106,1,107,0.05
Alandur,23,B Raji,Independent,28,0,28,0.01
Alandur,24,M.Valarmathi,Independent,229,10,239,0.1
Alandur,25,S.Sridhar,Independent,156,0,156,0.07
Alandur,26,NOTA,None of the Above,1878,10,1888,0.79
Alangudi,1,M.CHINNADURAI,Bahujan Samaj Party,442,2,444,0.26
Alangudi,2,DHARMA THANGAVEL,All India Anna Dravida Munnetra Kazhagam,61918,170,62088,36.13
Alangudi,3,SIVA.V.MEYYANATHAN,Dravida Munnetra Kazhagam,86743,1192,87935,51.17
Alangudi,4,C.THIRUCHELVAM,Naam Tamilar Katchi,15403,74,15477,9.01
Alangudi,5,P.BALAMURUGAN,My India Party,179,1,180,0.1
Alangudi,6,G.MANIMEGALAI,Communist Party of India  (Marxist-Leninist)  (Liberation),163,2,165,0.1
Alangudi,7,D.VIDANGAR,Amma Makkal Munnettra Kazagam,2899,25,2924,1.7
Alangudi,8,N.VAIRAVAN,Makkal Needhi Maiam,1221,9,1230,0.72
Alangudi,9,C.JAYA,Anaithu Makkal Puratchi Katchi,154,1,155,0.09
Alangudi,10,V.KANNADASAN,Independent,343,0,343,0.2
Alangudi,11,T.VINAYAGAMOORTHY,Independent,199,0,199,0.12
Alangudi,12,NOTA,None of the Above,699,3,702,0.41
Alangulam,1,PAUL MANOJ PANDIAN,All India Anna Dravida Munnetra Kazhagam,73846,307,74153,36.44
Alangulam,2,DR.POONGOTHAI ALADI ARUNA,Dravida Munnetra Kazhagam,69325,1289,70614,34.7
Alangulam,3,RAJENDRANATHAN,Desiya Murpokku Dravida Kazhagam,2797,19,2816,1.38
Alangulam,4,A.UDHAYAKUMAR,Puthiya Tamilagam,1098,7,1105,0.54
Alangulam,5,M.SANGEETHA ESAK,Naam Tamilar Katchi,12396,123,12519,6.15
Alangulam,6,S.SELVAKUMAR,Makkal Needhi Maiam,1439,15,1454,0.71
Alangulam,7,ARUNKUMAR.K,Independent,492,0,492,0.24
Alangulam,8,S.SANKAR GANESH YADAV,Independent,375,1,376,0.18
Alangulam,9,K.SIVARAM,Independent,435,1,436,0.21
Alangulam,10,HARI NADAR.A,Independent,37603,124,37727,18.54
Alangulam,11,NOTA,None of the Above,1772,14,1786,0.88
Ambasamudram,1,R.AVUDAIAPPAN,Dravida Munnetra Kazhagam,67267,1029,68296,38.44
Ambasamudram,2,E.SUBAYA,All India Anna Dravida Munnetra Kazhagam,84665,546,85211,47.96
Ambasamudram,3,MANIMARAN,Bahujan Samaj Party,505,4,509,0.29
Ambasamudram,4,C.GANESAN,Makkal Needhi Maiam,2765,42,2807,1.58
Ambasamudram,5,SHENBAGA VALLI,Naam Tamilar Katchi,13599,136,13735,7.73
Ambasamudram,6,C.RANI RANJITHAM,Amma Makkal Munnettra Kazagam,4146,48,4194,2.36
Ambasamudram,7,S. LAKSHMANAN,Veerath Thiyagi Viswanathadoss Thozhilalarkal Katchi,178,0,178,0.1
Ambasamudram,8,ABDUL MAJEETH,Independent,88,0,88,0.05
Ambasamudram,9,ARUNACHALAM,Independent,117,2,119,0.07
Ambasamudram,10,S.GANESAN,Independent,166,0,166,0.09
Ambasamudram,11,M.GAVASKAR,Independent,310,5,315,0.18
Ambasamudram,12,J.RAJESH DHARMASINGH PANDIAN,Independent,390,0,390,0.22
Ambasamudram,13,NOTA,None of the Above,1665,8,1673,0.94
Ambattur,1,V ALEXANDER,All India Anna Dravida Munnetra Kazhagam,71908,500,72408,30.13
Ambattur,2,R Radha,Nationalist Congress Party,613,2,615,0.26
Ambattur,3,JOSEPH SAMUEL,Dravida Munnetra Kazhagam,113371,1183,114554,47.67
Ambattur,4,R ANBU THENARASAN,Naam Tamilar Katchi,22638,63,22701,9.45
Ambattur,5,S Veena,Anaithu Makkal Arasiyal Katchi,231,2,233,0.1
Ambattur,6,S VEDHACHALAM,Amma Makkal Munnettra Kazagam,2616,15,2631,1.09
Ambattur,7,S VAITHESWARAN,Makkal Needhi Maiam,22286,84,22370,9.31
Ambattur,8,M S ARUMUGAM,Independent,141,1,142,0.06
Ambattur,9,N Ganesan,Independent,55,0,55,0.02
Ambattur,10,A S Kesavan,Independent,59,0,59,0.02
Ambattur,11,G Srinivasan,Independent,56,1,57,0.02
Ambattur,12,G Soma Sundaram,Independent,80,0,80,0.03
Ambattur,13,P Dhanraj,Independent,52,3,55,0.02
Ambattur,14,NARMADA NANDHAKUMAR,Independent,176,1,177,0.07
Ambattur,15,Bharadan,Independent,111,0,111,0.05
Ambattur,16,K Bharathi,Independent,801,6,807,0.34
Ambattur,17,S Praveen,Independent,251,0,251,0.1
Ambattur,18,A R MURUGAVEL,Independent,94,1,95,0.04
Ambattur,19,T MUNIANDI,Independent,156,0,156,0.06
Ambattur,20,Ravi,Independent,44,0,44,0.02
Ambattur,21,C RAGHUL,Independent,138,1,139,0.06
Ambattur,22,G Vijayakumar,Independent,39,0,39,0.02
Ambattur,23,T Joseph Samuvel SanthaKumar,Independent,162,0,162,0.07
Ambattur,24,NOTA,None of the Above,2332,26,2358,0.98
Ambur,1,NAZAR MOHAMED.K,All India Anna Dravida Munnetra Kazhagam,69903,341,70244,39.49
Ambur,2,WAZEER AHMED.J,Bahujan Samaj Party,678,3,681,0.38
Ambur,3,VILWANATHAN.A.C,Dravida Munnetra Kazhagam,89561,915,90476,50.86
Ambur,4,ASHOK KUMAR.C,Anaithu Makkal Puratchi Katchi,316,3,319,0.18
Ambur,5,UMAR FAROOK.ASA,SOCIAL DEMOCRATIC PARTY OF INDIA,1787,6,1793,1.01
Ambur,6,KAREEM BASHA.A,Rashtriya Ulama Council,81,1,82,0.05
Ambur,7,PARTHIBAN.V,All India Youth Development Party,101,0,101,0.06
Ambur,8,MANI.S.P,All Pensioner’s Party,358,5,363,0.2
Ambur,9,MAHARUNNISHA,Naam Tamilar Katchi,10102,48,10150,5.71
Ambur,10,RAJA.S,Makkal Needhi Maiam,1629,9,1638,0.92
Ambur,11,MURUGAN.L,Independent,199,2,201,0.11
Ambur,12,RAJINIKANTH.P,Independent,252,1,253,0.14
Ambur,13,GEORGE.V.A.,Independent,159,1,160,0.09
Ambur,14,NOTA,None of the Above,1410,7,1417,0.8
Anaikattu,1,A.P.Nandakumar,Dravida Munnetra Kazhagam,94084,1075,95159,48.11
Anaikattu,2,D.Velazhagan,All India Anna Dravida Munnetra Kazhagam,88031,768,88799,44.89
Anaikattu,3,V.D.Sathish Kumar,Amma Makkal Munnettra Kazagam,1125,15,1140,0.58
Anaikattu,4,A.Sumithra,Naam Tamilar Katchi,7974,151,8125,4.11
Anaikattu,5,K.Rajasekar,Indiya Jananayaka Katchi,323,5,328,0.17
Anaikattu,6,M.Arun,Independent,42,2,44,0.02
Anaikattu,7,R Karunamoorthy,Independent,61,1,62,0.03
Anaikattu,8,N.Kirubakaran,Independent,104,5,109,0.06
Anaikattu,9,M.Senthil Kumar,Independent,1335,22,1357,0.69
Anaikattu,10,K.Naveenkumar,Independent,93,1,94,0.05
Anaikattu,11,T.Mathan Kumar,Independent,149,1,150,0.08
Anaikattu,12,M RajBabu,Independent,179,0,179,0.09
Anaikattu,13,P Venkatesan,Independent,468,0,468,0.24
Anaikattu,14,NOTA,None of the Above,1768,23,1791,0.91
Andipatti,1,S.KAMATCHI,Bahujan Samaj Party,387,5,392,0.19
Andipatti,2,A.MAHARAJAN,Dravida Munnetra Kazhagam,92057,1484,93541,44.64
Andipatti,3,A.LOGIRAJAN,All India Anna Dravida Munnetra Kazhagam,84542,461,85003,40.57
Andipatti,4,C.KANIVEL,Anaithu Makkal Puratchi Katchi,650,0,650,0.31
Andipatti,5,S.GUNASEKARAN,Makkal Needhi Maiam,2958,52,3010,1.44
Andipatti,6,M.KUMARAN,My India Party,105,4,109,0.05
Andipatti,7,S.GOVINDHARAJ,All India MGR Makkal Munnetra Kazhagam,112,3,115,0.05
Andipatti,8,BALAMURUGAN,National Democratic Party of South India,122,5,127,0.06
Andipatti,9,A.VELUCHAMY,Anna Puratchi Thalaivar Amma Dravida Munnetra Kazhagam,114,1,115,0.05
Andipatti,10,JEYAKUMAR,Naam Tamilar Katchi,11034,182,11216,5.35
Andipatti,11,R.JEYAKUMAR,Amma Makkal Munnettra Kazagam,11746,150,11896,5.68
Andipatti,12,M.EASWARAN,Independent,125,2,127,0.06
Andipatti,13,K.KASENDRAN @ GAJENDRAN,Independent,84,1,85,0.04
Andipatti,14,M.DIVAKAR,Independent,115,0,115,0.05
Andipatti,15,P.PANIVURAJA,Independent,155,1,156,0.07
Andipatti,16,P.PANDIDURAI,Independent,226,1,227,0.11
Andipatti,17,MARIYAMMAL,Independent,148,1,149,0.07
Andipatti,18,M.RAGHUNATHAN,Independent,457,0,457,0.22
Andipatti,19,VELMANI,Independent,566,6,572,0.27
Andipatti,20,V.JEYAKODI,Independent,141,4,145,0.07
Andipatti,21,NOTA,None of the Above,1308,25,1333,0.64
Anna Nagar,1,S. Gokula Indira,All India Anna Dravida Munnetra Kazhagam,52297,312,52609,31.87
Anna Nagar,2,M.K. Mohan,Dravida Munnetra Kazhagam,79356,698,80054,48.49
Anna Nagar,3,D. JeevithKumar,Bahujan Samaj Party,220,0,220,0.13
Anna Nagar,4,Ansar Ahamed,Anaithu Makkal Arasiyal Katchi,69,0,69,0.04
Anna Nagar,5,K.N. Gunasekaran,Amma Makkal Munnettra Kazagam,1163,6,1169,0.71
Anna Nagar,6,S. Shankar,Naam Tamilar Katchi,10361,45,10406,6.3
Anna Nagar,7,P. Dhanasekar,Nam India Naam Indiyar Katchi,59,0,59,0.04
Anna Nagar,8,J. Nagaraj,New Generation People’s Party,53,0,53,0.03
Anna Nagar,9,V. Paulraj Guna,Republican Party of India (Athawale),73,0,73,0.04
Anna Nagar,10,S.D. Prabhakar,Tamil Nadu Ilangyar Katchi,406,2,408,0.25
Anna Nagar,11,V. Ponraj,Makkal Needhi Maiam,17434,88,17522,10.61
Anna Nagar,12,S. Yuvaraja,Veerath Thiyagi Viswanathadoss Thozhilalarkal Katchi,56,0,56,0.03
Anna Nagar,13,M. Veriyandi,Anna MGR Dravida Makkal Kalgam,32,0,32,0.02
Anna Nagar,14,L. Kasinathan,Independent,74,0,74,0.04
Anna Nagar,15,P.E. Gopinath,Independent,62,0,62,0.04
Anna Nagar,16,S. Sathyanarayanan,Independent,158,0,158,0.1
Anna Nagar,17,K. Sathish Kumar,Independent,125,0,125,0.08
Anna Nagar,18,R. Saravanan,Independent,122,0,122,0.07
Anna Nagar,19,V.M. Nagarajan,Independent,84,2,86,0.05
Anna Nagar,20,P. Manimaran,Independent,13,0,13,0.01
Anna Nagar,21,M. Manokaran,Independent,27,0,27,0.02
Anna Nagar,22,A. Jayaprakash,Independent,12,0,12,0.01
Anna Nagar,23,Hari Shankar,Independent,141,1,142,0.09
Anna Nagar,24,NOTA,None of the Above,1529,16,1545,0.94
Anthiyur,1,SHANMUGAVEL.K.S,All India Anna Dravida Munnetra Kazhagam,77474,347,77821,44.12
Anthiyur,2,PATTAN.G,Bahujan Samaj Party,956,1,957,0.54
Anthiyur,3,VENKATACHALAM.A.G,Dravida Munnetra Kazhagam,78038,1058,79096,44.84
Anthiyur,4,GURUNATHAN.M,Makkal Needhi Maiam,2466,8,2474,1.4
Anthiyur,5,SARAVANAN.M,Naam Tamilar Katchi,8162,68,8230,4.67
Anthiyur,6,SELVAM.S.R,Amma Makkal Munnettra Kazagam,1207,5,1212,0.69
Anthiyur,7,BAKKIYAM.M,India Dravida Makkal Munnetra Katchi,103,0,103,0.06
Anthiyur,8,PRATHABAN.A,Ahimsa Socialist Party,2035,10,2045,1.16
Anthiyur,9,RAJENDRAN.K,Ganasangam Party of India,229,0,229,0.13
Anthiyur,10,ANBALAGAN.K,Independent,198,1,199,0.11
Anthiyur,11,KARTHIKEYAN.R,Independent,130,2,132,0.07
Anthiyur,12,GEETHA.M,Independent,151,1,152,0.09
Anthiyur,13,KUMARASAMY.R,Independent,224,1,225,0.13
Anthiyur,14,SHANMUGAM.K,Independent,503,0,503,0.29
Anthiyur,15,SENGUTTUVAN.M.R,Independent,183,1,184,0.1
Anthiyur,16,THANGAVEL.M,Independent,543,0,543,0.31
Anthiyur,17,POORNACHANDRAN.S,Independent,567,0,567,0.32
Anthiyur,18,PERIYASAMY.T,Independent,146,1,147,0.08
Anthiyur,19,MUTHUSAMY.M,Independent,428,0,428,0.24
Anthiyur,20,SHEIKDAVOOD.A.M,Independent,110,1,111,0.06
Anthiyur,21,NOTA,None of the Above,1017,10,1027,0.58
Arakkonam,1,P.SUDHAKAR,Bahujan Samaj Party,1816,9,1825,1.06
Arakkonam,2,S.RAVI,All India Anna Dravida Munnetra Kazhagam,85057,342,85399,49.82
Arakkonam,3,E.ABIRAMI,Naam Tamilar Katchi,14561,70,14631,8.54
Arakkonam,4,GOWTHAMA SANNAH.J,Viduthalai Chiruthaigal Katchi,57345,885,58230,33.97
Arakkonam,5,S.BASKARAN,Makkal Needhi Maiam,3522,21,3543,2.07
Arakkonam,6,K.C.MANIVANNAN,Amma Makkal Munnettra Kazagam,4747,30,4777,2.79
Arakkonam,7,V.RAVI,Independent,96,1,97,0.06
Arakkonam,8,A.GAUTHAMAN,Independent,109,3,112,0.07
Arakkonam,9,C.M.GOWTHAMAN,Independent,284,1,285,0.17
Arakkonam,10,M.MANIKANDAN,Independent,111,2,113,0.07
Arakkonam,11,M.MADHANRAJ,Independent,184,0,184,0.11
Arakkonam,12,C.MOHAN,Independent,128,0,128,0.07
Arakkonam,13,P.RAVI,Independent,432,0,432,0.25
Arakkonam,14,NOTA,None of the Above,1648,8,1656,0.97
Arani,1,S.S.ANBALAGAN,Dravida Munnetra Kazhagam,98386,1447,99833,45.09
Arani,2,K.ANBU,Bahujan Samaj Party,330,2,332,0.15
Arani,3,G.BASKARAN,Desiya Murpokku Dravida Kazhagam,1852,9,1861,0.84
Arani,4,S.RAMACHANDRAN,All India Anna Dravida Munnetra Kazhagam,102225,736,102961,46.5
Arani,5,S.THANIGAIVEL,Veerath Thiyagi Viswanathadoss Thozhilalarkal Katchi,506,3,509,0.23
Arani,6,D.PRAKALATHA,Naam Tamilar Katchi,10373,118,10491,4.74
Arani,7,V.MANIGANDAN,Makkal Needhi Maiam,2196,17,2213,1
Arani,8,A.ARUNKUMAR,Independent,217,5,222,0.1
Arani,9,K.ANBALAGAN,Independent,56,19,75,0.03
Arani,10,M.ANBALAGAN,Independent,78,2,80,0.04
Arani,11,N.KARTHIKEYAN,Independent,395,2,397,0.18
Arani,12,S.SAKTHIVEL,Independent,165,13,178,0.08
Arani,13,R.DHAKSHANAMOORTHY,Independent,313,0,313,0.14
Arani,14,S.MURALI,Independent,133,0,133,0.06
Arani,15,S.RAMACHANDRAN,Independent,133,1,134,0.06
Arani,16,NOTA,None of the Above,1666,24,1690,0.76
Aranthangi,1,RAMACHANDRAN T,Indian National Congress,80902,933,81835,48.7
Aranthangi,2,RAJANAYAGAM M,All India Anna Dravida Munnetra Kazhagam,50655,287,50942,30.31
Aranthangi,3,JEEVA A,Bahujan Samaj Party,633,3,636,0.38
Aranthangi,4,AMALADOSS SANDHIYAGU,Puthiya Tamilagam,599,13,612,0.36
Aranthangi,5,RAMALINGASWAMI ADIHITHAN. PPC,Akhila India Jananayaka Makkal Katchi (Dr. Isaac),167,1,168,0.1
Aranthangi,6,KUMARAPPAN B,My India Party,125,0,125,0.07
Aranthangi,7,SAKTHIVEL K,Tamizhaga Murpokku Makkal Katchi,162,0,162,0.1
Aranthangi,8,SIVASHANMUGAM K,Amma Makkal Munnettra Kazagam,4678,21,4699,2.8
Aranthangi,9,SHAIK MOHAMED B,Makkal Needhi Maiam,960,6,966,0.57
Aranthangi,10,HUMAYUN KABIR M I,Naam Tamilar Katchi,18398,62,18460,10.98
Aranthangi,11,ARJUNAN R,Independent,140,0,140,0.08
Aranthangi,12,SYED SULTHAN IBRAHIM A,Independent,201,1,202,0.12
Aranthangi,13,SELVAKUMAR K,Independent,391,0,391,0.23
Aranthangi,14,TILLAINATHAN R,Independent,179,1,180,0.11
Aranthangi,15,"DHETCHENA MOORTHY, Dr. S",Independent,1064,16,1080,0.64
Aranthangi,16,PANDIYAN V,Independent,505,0,505,0.3
Aranthangi,17,MAHENDRAN K,Independent,493,0,493,0.29
Aranthangi,18,MUTHUKKARUPPAIAH K,Independent,334,0,334,0.2
Aranthangi,19,MUTHUSELVAM V,Independent,2159,5,2164,1.29
Aranthangi,20,RAMASAMY R S,Independent,212,0,212,0.13
Aranthangi,21,VELRAJ. K P,Independent,3150,14,3164,1.88
Aranthangi,22,JEGADEESAN R,Independent,54,0,54,0.03
Aranthangi,23,NOTA,None of the Above,524,0,524,0.31
Aravakurichi,1,ANNAMALAI. K,Bharatiya Janata Party,67915,638,68553,38.71
Aravakurichi,2,ELANGO. R,Dravida Munnetra Kazhagam,92215,1154,93369,52.72
Aravakurichi,3,SUNDARARAJ. R,Bahujan Samaj Party,328,0,328,0.19
Aravakurichi,4,ANITHA PARVEEN. M,Naam Tamilar Katchi,7156,32,7188,4.06
Aravakurichi,5,THANGAVEL.  P. S. N,Amma Makkal Munnettra Kazagam,1593,6,1599,0.9
Aravakurichi,6,MOHAMMED HANEEF SHAHIL. K. S,Makkal Needhi Maiam,1375,7,1382,0.78
Aravakurichi,7,MOHANRAJ. C,Samaniya Makkal Nala Katchi,21,1,22,0.01
Aravakurichi,8,RAJKUMAR. R,Tamil Nadu Ilangyar Katchi,375,2,377,0.21
Aravakurichi,9,ARIVALAGAN. T,Independent,53,0,53,0.03
Aravakurichi,10,ARUMUGAM. R,Independent,29,0,29,0.02
Aravakurichi,11,KARTHIKEYAN. R,Independent,63,0,63,0.04
Aravakurichi,12,KARTHIK. D,Independent,45,0,45,0.03
Aravakurichi,13,KIRUBANANTH. S,Independent,41,0,41,0.02
Aravakurichi,14,SAKUNTHALA. N,Independent,79,0,79,0.04
Aravakurichi,15,SATHEESHKUMAR. T,Independent,336,0,336,0.19
Aravakurichi,16,SARAVANAN. P,Independent,1236,0,1236,0.7
Aravakurichi,17,CHITHAMBARAM. A,Independent,240,0,240,0.14
Aravakurichi,18,SILAMBARASAN. P,Independent,129,0,129,0.07
Aravakurichi,19,SIVAKUMAR. A,Independent,28,0,28,0.02
Aravakurichi,20,SURESH. M,Independent,19,0,19,0.01
Aravakurichi,21,SURESHBABU. S,Independent,24,0,24,0.01
Aravakurichi,22,SELVAKUMAR. R,Independent,19,0,19,0.01
Aravakurichi,23,THANEGASALAM. R. V,Independent,20,1,21,0.01
Aravakurichi,24,BASKARAN. N,Independent,24,1,25,0.01
Aravakurichi,25,PITCHAIMUTHU. T,Independent,24,0,24,0.01
Aravakurichi,26,PRAKASH. P,Independent,16,0,16,0.01
Aravakurichi,27,PRABAKARAN. T,Independent,20,1,21,0.01
Aravakurichi,28,PRABHU. G,Independent,16,0,16,0.01
Aravakurichi,29,BOOPATHY. S,Independent,27,0,27,0.02
Aravakurichi,30,PERIYASAMY. M. R,Independent,40,0,40,0.02
Aravakurichi,31,MAHESHMANI. T,Independent,104,0,104,0.06
Aravakurichi,32,MATHIYALAGAN. P,Independent,161,0,161,0.09
Aravakurichi,33,MANOJPANDIYAN. J. M,Independent,290,0,290,0.16
Aravakurichi,34,MURUGESAN. M. S,Independent,174,0,174,0.1
Aravakurichi,35,RAGUNATH. P,Independent,23,0,23,0.01
Aravakurichi,36,RANJITH. I,Independent,21,0,21,0.01
Aravakurichi,37,RAMAGURU. R,Independent,19,1,20,0.01
Aravakurichi,38,RAJENDIRAN. M,Independent,44,0,44,0.02
Aravakurichi,39,VIVEKANANTHAN. V,Independent,13,0,13,0.01
Aravakurichi,40,VAIRASEEMAN. G,Independent,46,0,46,0.03
Aravakurichi,41,NOTA,None of the Above,866,3,869,0.49
Arcot,1,J.L.Eswarappan,Dravida Munnetra Kazhagam,102667,1218,103885,49.52
Arcot,2,A.C.Kesavan,Bahujan Samaj Party,771,11,782,0.37
Arcot,3,Elavazagan.K.L,Pattali Makkal Katchi,83410,517,83927,40.01
Arcot,4,R.Kathiravan,Naam Tamilar Katchi,11977,111,12088,5.76
Arcot,5,H.Mohamed Ghouse,Tipu Sultan Party,392,5,397,0.19
Arcot,6,A.R.Mohamed Raffi,Makkal Needhi Maiam,2846,14,2860,1.36
Arcot,7,Munivel.S,National Democratic Party of South India,180,4,184,0.09
Arcot,8,N.Janarthanan,Amma Makkal Munnettra Kazagam,2159,31,2190,1.04
Arcot,9,P.Eswaran,Independent,155,0,155,0.07
Arcot,10,T.D.Shanmugam,Independent,231,0,231,0.11
Arcot,11,K.Manigandan,Independent,453,4,457,0.22
Arcot,12,Vasanthakumar,Independent,380,2,382,0.18
Arcot,13,NOTA,None of the Above,2238,15,2253,1.07
Ariyalur,1,SAVARIANANDHAM V,Bahujan Samaj Party,483,3,486,0.22
Ariyalur,2,CHINNAPPA K,Dravida Munnetra Kazhagam,102964,1011,103975,46.16
Ariyalur,3,RAJENDRAN S,All India Anna Dravida Munnetra Kazhagam,100436,305,100741,44.73
Ariyalur,4,THANGA. SHANMUGA SUNDARAM,New Generation People’s Party,1028,9,1037,0.46
Ariyalur,5,SUGUNA KUMAR,Naam Tamilar Katchi,12285,61,12346,5.48
Ariyalur,6,DURAI.MANIVEL,Amma Makkal Munnettra Kazagam,2040,4,2044,0.91
Ariyalur,7,JAWAHAR P,Indiya Jananayaka Katchi,896,9,905,0.4
Ariyalur,8,KUMAR J,Independent,73,1,74,0.03
Ariyalur,9,SIVATHASAN V,Independent,159,0,159,0.07
Ariyalur,10,DEVA P,Independent,127,6,133,0.06
Ariyalur,11,MANIKANNAN M,Independent,539,1,540,0.24
Ariyalur,12,RAMESH K,Independent,766,1,767,0.34
Ariyalur,13,RAVICHANDRAN S,Independent,630,2,632,0.28
Ariyalur,14,NOTA,None of the Above,1383,3,1386,0.62
Aruppukkottai,1,K.K.S.S.R.RAMACHANDRAN,Dravida Munnetra Kazhagam,88928,2112,91040,53.18
Aruppukkottai,2,G.SUBBURAJ,Bahujan Samaj Party,270,2,272,0.16
Aruppukkottai,3,R.RAMESH,Desiya Murpokku Dravida Kazhagam,2505,27,2532,1.48
Aruppukkottai,4,VAIGAICHELVAN,All India Anna Dravida Munnetra Kazhagam,51614,392,52006,30.38
Aruppukkottai,5,UMA,Naam Tamilar Katchi,12271,121,12392,7.24
Aruppukkottai,6,V.UMADEVI,Makkal Needhi Maiam,7550,88,7638,4.46
Aruppukkottai,7,M.KARUPPASAMY,Puthiya Tamilagam,460,18,478,0.28
Aruppukkottai,8,S.DEENATHAYALAN,Anaithu Makkal Puratchi Katchi,58,0,58,0.03
Aruppukkottai,9,S.PANDIYAN,Bahujan Dravida Party,48,0,48,0.03
Aruppukkottai,10,A.P.S.JOHNSON,My India Party,55,2,57,0.03
Aruppukkottai,11,G.RANJITH,Independent,57,0,57,0.03
Aruppukkottai,12,R.S.RAMACHANDRAN,Independent,67,0,67,0.04
Aruppukkottai,13,THANGAPANDIAN,Independent,425,1,426,0.25
Aruppukkottai,14,THANGA VADIVEL.A.N,Independent,61,1,62,0.04
Aruppukkottai,15,DHANASEKARAPANDIAN,Independent,76,0,76,0.04
Aruppukkottai,16,P.PRASANTH,Independent,436,0,436,0.25
Aruppukkottai,17,K. BOOMINATHAN,Independent,630,0,630,0.37
Aruppukkottai,18,V. POORNISHA,Independent,217,2,219,0.13
Aruppukkottai,19,Ponmuniasamy,Independent,118,0,118,0.07
Aruppukkottai,20,S.MANIVANNAN,Independent,190,0,190,0.11
Aruppukkottai,21,M MUTHUMARIAPPAN,Independent,128,0,128,0.07
Aruppukkottai,22,E.RAMACHANDRAN,Independent,72,0,72,0.04
Aruppukkottai,23,G.RAMACHANDRAN,Independent,60,0,60,0.04
Aruppukkottai,24,S.RAMACHANDRAN,Independent,189,0,189,0.11
Aruppukkottai,25,T.RAMACHANDRAN,Independent,39,0,39,0.02
Aruppukkottai,26,R.RAMACHANDRAN,Independent,71,0,71,0.04
Aruppukkottai,27,LINGAPANDI,Independent,419,0,419,0.24
Aruppukkottai,28,VIJAYAKUMAR,Independent,60,0,60,0.04
Aruppukkottai,29,VENKATESAN,Independent,38,0,38,0.02
Aruppukkottai,30,NOTA,None of the Above,1316,7,1323,0.77
Athoor,1,KARTHIGAISELVAN K,Bahujan Samaj Party,740,9,749,0.33
Athoor,2,PERIYASAMY I,Dravida Munnetra Kazhagam,164169,1640,165809,72.11
Athoor,3,SILAMBARASAN M,Puthiya Tamilagam,878,2,880,0.38
Athoor,4,SIVASAKTHIVEL P,Makkal Needhi Maiam,3211,30,3241,1.41
Athoor,5,SELVAKUMAR P,Amma Makkal Munnettra Kazagam,2991,26,3017,1.31
Athoor,6,SIMON JUSTIN A,Naam Tamilar Katchi,17017,151,17168,7.47
Athoor,7,THILAGABAMA M,Pattali Makkal Katchi,30018,220,30238,13.15
Athoor,8,MUTHULAKSHMI R,Anna Puratchi Thalaivar Amma Dravida Munnetra Kazhagam,1178,2,1180,0.51
Athoor,9,RAGUPATHI P,Anaithu Makkal Puratchi Katchi,87,0,87,0.04
Athoor,10,JEYASEKARAN R,My India Party,87,1,88,0.04
Athoor,11,ANBU AS,Independent,534,1,535,0.23
Athoor,12,KARTHI M,Independent,321,1,322,0.14
Athoor,13,SANKAR D,Independent,700,0,700,0.3
Athoor,14,SAVADAMUTHU A,Independent,1706,16,1722,0.75
Athoor,15,SILAMBARASAN P,Independent,486,0,486,0.21
Athoor,16,THILAGAVATHY S,Independent,347,2,349,0.15
Athoor,17,BALAMURUGAN A,Independent,190,0,190,0.08
Athoor,18,PALRAJ R,Independent,1352,5,1357,0.59
Athoor,19,MURUGANANTHAM C,Independent,125,0,125,0.05
Athoor,20,VEERAMALAI S,Independent,133,0,133,0.06
Athoor,21,NOTA,None of the Above,1543,21,1564,0.68
Attur,1,"CHINNADURAI, K.",Dravida Munnetra Kazhagam,85243,1808,87051,43.58
Attur,2,"PERIYANNAN, M.",Bahujan Samaj Party,492,2,494,0.25
Attur,3,"JAYASANKARAN, A.P.",All India Anna Dravida Munnetra Kazhagam,94262,1046,95308,47.72
Attur,4,"KRISHNAVENI, S.",Naam Tamilar Katchi,10141,92,10233,5.12
Attur,5,"SADHA SIVAM, R.",Ambedkarite Party of India,240,1,241,0.12
Attur,6,"SIVAKUMAR, P.",Makkal Needhi Maiam,1937,22,1959,0.98
Attur,7,"MADHESWARAN, S.",Amma Makkal Munnettra Kazagam,1675,24,1699,0.85
Attur,8,"MATHESWARI, K.K.",Anna Dravidar Kazhagam,117,3,120,0.06
Attur,9,"JANARTHANAM, A.",Dhesiya Makkal Kazhagam,215,0,215,0.11
Attur,10,"ARUMUGAM, D.",Independent,367,0,367,0.18
Attur,11,"SILAMBARASAN, J.",Independent,222,0,222,0.11
Attur,12,NOTA,None of the Above,1817,17,1834,0.92
Avadi,1,Sankar N M,Desiya Murpokku Dravida Kazhagam,1895,16,1911,0.64
Avadi,2,CHARLES S,Bahujan Samaj Party,763,10,773,0.26
Avadi,3,Nasar S M,Dravida Munnetra Kazhagam,148845,1442,150287,49.94
Avadi,4,Pandiarajan K,All India Anna Dravida Munnetra Kazhagam,94331,681,95012,31.57
Avadi,5,Udhayakumar V,Makkal Needhi Maiam,16982,110,17092,5.68
Avadi,6,Balasubramanian M,Tamil Nadu Ilangyar Katchi,1251,12,1263,0.42
Avadi,7,Banumathi,My India Party,126,1,127,0.04
Avadi,8,Raman N,Tamilnadu Makkal Nalvazhvu Periyakkam,120,0,120,0.04
Avadi,9,VIJAYALAKSHMI G,Naam Tamilar Katchi,29953,134,30087,10
Avadi,10,Viswanathan R,MGR Makkal Katchi,108,0,108,0.04
Avadi,11,Akilan T.M.,Independent,72,0,72,0.02
Avadi,12,Chandrasekar.A,Independent,105,0,105,0.03
Avadi,13,Sugumar M,Independent,143,0,143,0.05
Avadi,14,Dharani K,Independent,184,3,187,0.06
Avadi,15,Durgaprasad G,Independent,73,2,75,0.02
Avadi,16,Nagaraj M,Independent,198,0,198,0.07
Avadi,17,Pandiarajan G,Independent,359,1,360,0.12
Avadi,18,Venkatesan M,Independent,95,0,95,0.03
Avadi,19,Jayakumar P,Independent,299,1,300,0.1
Avadi,20,Shanavas Khan J,Independent,231,0,231,0.08
Avadi,21,NOTA,None of the Above,2361,20,2381,0.79
Avanashi,1,ATHIYAMAAN RAJU,Dravida Munnetra Kazhagam,65453,929,66382,31.22
Avanashi,2,"DHANAPAL, P",All India Anna Dravida Munnetra Kazhagam,116674,610,117284,55.16
Avanashi,3,"DURAISAMY, P",Bahujan Samaj Party,831,2,833,0.39
Avanashi,4,"MEERA, K",Desiya Murpokku Dravida Kazhagam,2554,23,2577,1.21
Avanashi,5,"SUBRAMANI, K",India Dravida Makkal Munnetra Katchi,137,2,139,0.07
Avanashi,6,SHOBA,Naam Tamilar Katchi,13211,45,13256,6.23
Avanashi,7,"VENKATESWARAN, A",Makkal Needhi Maiam,8318,61,8379,3.94
Avanashi,8,ANNAMALAI,Independent,150,4,154,0.07
Avanashi,9,"ARUMUGAM, P",Independent,171,2,173,0.08
Avanashi,10,"SAKUNTHALA, T",Independent,178,1,179,0.08
Avanashi,11,"MURUGESAN, R",Independent,379,0,379,0.18
Avanashi,12,"RANGASAMY, P",Independent,520,0,520,0.24
Avanashi,13,NOTA,None of the Above,2352,20,2372,1.12
Bargur,1,KRISHNAN A,All India Anna Dravida Munnetra Kazhagam,84177,465,84642,42.8
Bargur,2,NIRMALA A,National People's Party,701,9,710,0.36
Bargur,3,MATHIAZHAGAN D,Dravida Munnetra Kazhagam,95852,1404,97256,49.17
Bargur,4,MURALI M,Bahujan Samaj Party,442,1,443,0.22
Bargur,5,ARUN GOWTHAM R,Indiya Jananayaka Katchi,337,8,345,0.17
Bargur,6,AANDI A,Veerath Thiyagi Viswanathadoss Thozhilalarkal Katchi,120,1,121,0.06
Bargur,7,GANESA KUMAR S,Amma Makkal Munnettra Kazagam,1058,6,1064,0.54
Bargur,8,KARUNAKARAN K,Naam Tamilar Katchi,10019,94,10113,5.11
Bargur,9,VASANTHARAJ P,Anna Puratchi Thalaivar Amma Dravida Munnetra Kazhagam,181,3,184,0.09
Bargur,10,KALPANA D,Independent,115,4,119,0.06
Bargur,11,KRISHNAN A,Independent,106,1,107,0.05
Bargur,12,SANTHAMOORTHI K,Independent,223,0,223,0.11
Bargur,13,MANJUNATHAN M,Independent,622,1,623,0.31
Bargur,14,MANI K,Independent,327,0,327,0.17
Bargur,15,NOTA,None of the Above,1496,11,1507,0.76
Bhavani,1,KARUPPANAN.K.C,All India Anna Dravida Munnetra Kazhagam,100285,630,100915,50.11
Bhavani,2,GOPAL.M,Bahujan Samaj Party,868,2,870,0.43
Bhavani,3,DURAIRAJ.K.P,Dravida Munnetra Kazhagam,77079,1313,78392,38.93
Bhavani,4,AMMASAI.K,Kongu  Desa  Marumalarchi  Makkal  Katchi,936,7,943,0.47
Bhavani,5,SADHANANDHAM.K,Makkal Needhi Maiam,4186,35,4221,2.1
Bhavani,6,SATHYA.M,Naam Tamilar Katchi,10410,61,10471,5.2
Bhavani,7,RADHAKRISHNAN.M,Amma Makkal Munnettra Kazagam,953,3,956,0.47
Bhavani,8,JANARTHANAM.R.P,Tamilaga Makkal Thannurimai Katchi,320,2,322,0.16
Bhavani,9,ABDUL KADHER.A,Independent,107,0,107,0.05
Bhavani,10,APPICHI.T.K,Independent,99,0,99,0.05
Bhavani,11,KARTHIKEYAN.P,Independent,121,1,122,0.06
Bhavani,12,SATHEESH KUMAR.P,Independent,1221,3,1224,0.61
Bhavani,13,PERUMAL.V.M,Independent,419,0,419,0.21
Bhavani,14,STANLEY.G,Independent,244,1,245,0.12
Bhavani,15,NOTA,None of the Above,2070,9,2079,1.03
Bhavanisagar,1,G.SAKTHIVEL,Bahujan Samaj Party,1194,3,1197,0.6
Bhavanisagar,2,P.L SUNDARAM,Communist Party of India,82200,973,83173,41.47
Bhavanisagar,3,A.Bannari,All India Anna Dravida Munnetra Kazhagam,98934,247,99181,49.45
Bhavanisagar,4,RAMESH.G,Desiya Murpokku Dravida Kazhagam,2193,4,2197,1.1
Bhavanisagar,5,KARTHIKKUMAR.K,Makkal Needhi Maiam,4280,17,4297,2.14
Bhavanisagar,6,V.SANGEETHA,Naam Tamilar Katchi,8479,38,8517,4.25
Bhavanisagar,7,NOTA,None of the Above,2003,2,2005,1
Bhuvanagiri,1,Arunmozhithevan. A,All India Anna Dravida Munnetra Kazhagam,95536,917,96453,48.92
Bhuvanagiri,2,Ezhilvendhan. R,Bahujan Samaj Party,503,1,504,0.26
Bhuvanagiri,3,Saravanan. Durai.K,Dravida Munnetra Kazhagam,87217,977,88194,44.73
Bhuvanagiri,4,Balamurugan. K.S.K,Amma Makkal Munnettra Kazagam,2464,6,2470,1.25
Bhuvanagiri,5,Rathinavel. R.,Naam Tamilar Katchi,6927,31,6958,3.53
Bhuvanagiri,6,Revathi. R.,Indiya Jananayaka Katchi,314,1,315,0.16
Bhuvanagiri,7,Anandan. S (a) Kavignar Sella Aananthamaalai,Independent,102,0,102,0.05
Bhuvanagiri,8,Ezhilvendan. P.,Independent,55,0,55,0.03
Bhuvanagiri,9,Saravanan. J.,Independent,192,4,196,0.1
Bhuvanagiri,10,Sivakumari. T,Independent,68,0,68,0.03
Bhuvanagiri,11,Pazhanivel. M,Independent,141,1,142,0.07
Bhuvanagiri,12,Balamurugan. G.C,Independent,132,1,133,0.07
Bhuvanagiri,13,Ranjith. R,Independent,333,0,333,0.17
Bhuvanagiri,14,Jeyakumar. K,Independent,184,0,184,0.09
Bhuvanagiri,15,NOTA,None of the Above,1058,0,1058,0.54
Bodinayakanur,1,THANGATAMILSELVAN,Dravida Munnetra Kazhagam,87142,1887,89029,41.45
Bodinayakanur,2,O.PANNEERSELVAM,All India Anna Dravida Munnetra Kazhagam,99296,754,100050,46.58
Bodinayakanur,3,K.I.M HAKKEEM,All India Trinamool Congress,552,7,559,0.26
Bodinayakanur,4,ARUN KUMAR,My India Party,139,4,143,0.07
Bodinayakanur,5,P.GANESH KUMAR,Makkal Needhi Maiam,4069,59,4128,1.92
Bodinayakanur,6,P.KARUPPIAH,Bahujan Dravida Party,77,0,77,0.04
Bodinayakanur,7,THENI.T.KARNAN,Anna Dravidar Kazhagam,80,0,80,0.04
Bodinayakanur,8,S.KRISHNAVENI,Anna Puratchi Thalaivar Amma Dravida Munnetra Kazhagam,98,2,100,0.05
Bodinayakanur,9,M.PREM CHANDAR,Naam Tamilar Katchi,10982,132,11114,5.17
Bodinayakanur,10,M.MUTHUSAMY,Amma Makkal Munnettra Kazagam,5594,55,5649,2.63
Bodinayakanur,11,A.ABTHAHIR,Independent,53,1,54,0.03
Bodinayakanur,12,C.ANBAZHAKAN,Independent,91,3,94,0.04
Bodinayakanur,13,M.ANANTHARAJ,Independent,269,1,270,0.13
Bodinayakanur,14,N.KRISHNAN,Independent,125,1,126,0.06
Bodinayakanur,15,P.KUMARAGURUBARAN,Independent,218,1,219,0.1
Bodinayakanur,16,N.SALEEM,Independent,353,1,354,0.16
Bodinayakanur,17,G.SENTHIL KUMAR,Independent,402,0,402,0.19
Bodinayakanur,18,TAMILSELVAN,Independent,441,2,443,0.21
Bodinayakanur,19,V.NANDHAGOPAL,Independent,68,0,68,0.03
Bodinayakanur,20,P.NAGENDHREN,Independent,133,2,135,0.06
Bodinayakanur,21,P.MANIMARAN,Independent,108,9,117,0.05
Bodinayakanur,22,V.RAMPRAKAASH,Independent,69,2,71,0.03
Bodinayakanur,23,RAJA MOHAMED,Independent,45,3,48,0.02
Bodinayakanur,24,T.RAJA MOHAMED,Independent,62,0,62,0.03
Bodinayakanur,25,NOTA,None of the Above,1381,22,1403,0.65
Chengalpattu,1,GAJENDRAN.M,All India Anna Dravida Munnetra Kazhagam,103561,347,103908,37.91
Chengalpattu,2,VARALAKSHMI.M,Dravida Munnetra Kazhagam,129317,1256,130573,47.64
Chengalpattu,3,ERANIAPPAN.S,Communist Party of India  (Marxist-Leninist)  (Liberation),684,0,684,0.25
Chengalpattu,4,SANJEEVINATHAN.K,Naam Tamilar Katchi,26813,55,26868,9.8
Chengalpattu,5,SATHISHKUMAR.A,Amma Makkal Munnettra Kazagam,3063,6,3069,1.12
Chengalpattu,6,SARAVANAN.D,All India Jananayaka Makkal Kazhagam,195,0,195,0.07
Chengalpattu,7,DILLIBABU.S,Tipu Sultan Party,403,1,404,0.15
Chengalpattu,8,MUTHAMILSELVAN.S,Indiya Jananayaka Katchi,4133,13,4146,1.51
Chengalpattu,9,VASUMATHI.G,Anaithu Makkal Arasiyal Katchi,141,1,142,0.05
Chengalpattu,10,GOPALAKRISHNAN.N,Independent,129,0,129,0.05
Chengalpattu,11,SEETHALAKSHMI.I,Independent,314,3,317,0.12
Chengalpattu,12,RAJAGOPAL.G,Independent,233,0,233,0.09
Chengalpattu,13,VEERADOSS.E,Independent,343,1,344,0.13
Chengalpattu,14,NOTA,None of the Above,3058,17,3075,1.12
Chengam,1,ANBU.S,Desiya Murpokku Dravida Kazhagam,2741,28,2769,1.24
Chengam,2,GIRI.M.P,Dravida Munnetra Kazhagam,106185,1896,108081,48.26
Chengam,3,SHANMUGAM.G,Bahujan Samaj Party,790,11,801,0.36
Chengam,4,NAINAKANNU.M.S,All India Anna Dravida Munnetra Kazhagam,95280,1231,96511,43.09
Chengam,5,SUGANRAJ.S,Indiya Jananayaka Katchi,823,5,828,0.37
Chengam,6,BASKAR.S,New Generation People’s Party,171,3,174,0.08
Chengam,7,VENNILA.S,Naam Tamilar Katchi,11980,100,12080,5.39
Chengam,8,ARUNKUMAR.M,Independent,111,1,112,0.05
Chengam,9,ANBAZHAGAN.P.G,Independent,110,2,112,0.05
Chengam,10,SHARMA.S,Independent,85,42,127,0.06
Chengam,11,SIVAKUMAR.J,Independent,99,0,99,0.04
Chengam,12,SIVAPRAKASH.K,Independent,139,34,173,0.08
Chengam,13,SELVARAJI.V,Independent,379,2,381,0.17
Chengam,14,DHINAKARAN.H,Independent,200,0,200,0.09
Chengam,15,VIJAYACHANDRAN.G,Independent,417,0,417,0.19
Chengam,16,NOTA,None of the Above,1079,6,1085,0.48
Chepauk-Thiruvallikeni,1,UDHAYANIDHI STALIN,Dravida Munnetra Kazhagam,92636,649,93285,67.89
Chepauk-Thiruvallikeni,2,RAGHU C,Bahujan Samaj Party,715,8,723,0.53
Chepauk-Thiruvallikeni,3,ABID BAKSHQ H HUSSAIN,Republican Party of India (Athawale),104,1,105,0.08
Chepauk-Thiruvallikeni,4,RAVI M L,Desiya Makkal Sakthi Katchi,89,0,89,0.06
Chepauk-Thiruvallikeni,5,RAJENDRAN L,Amma Makkal Munnettra Kazagam,1865,8,1873,1.36
Chepauk-Thiruvallikeni,6,KASSALI A.V.A,Pattali Makkal Katchi,23763,167,23930,17.42
Chepauk-Thiruvallikeni,7,TABREZ,Tipu Sultan Party,366,1,367,0.27
Chepauk-Thiruvallikeni,8,MOHAMMED IDRIS K,Indiya Jananayaka Katchi,4090,6,4096,2.98
Chepauk-Thiruvallikeni,9,MOHAMED RIOZ,Anaithu Makkal Arasiyal Katchi,112,0,112,0.08
Chepauk-Thiruvallikeni,10,JAYASIMMARAJA  S M,Naam Tamilar Katchi,9170,23,9193,6.69
Chepauk-Thiruvallikeni,11,ANANDAN  K,Independent,87,1,88,0.06
Chepauk-Thiruvallikeni,12,KANNAN C,Independent,63,2,65,0.05
Chepauk-Thiruvallikeni,13,Ganesan P,Independent,39,0,39,0.03
Chepauk-Thiruvallikeni,14,KRISHNADASAN S,Independent,57,0,57,0.04
Chepauk-Thiruvallikeni,15,CHANDRANATHAN S,Independent,118,0,118,0.09
Chepauk-Thiruvallikeni,16,SRINIVASAN,Independent,138,1,139,0.1
Chepauk-Thiruvallikeni,17,SENTHIL KUMAR H,Independent,244,0,244,0.18
Chepauk-Thiruvallikeni,18,DILLIRAJ P,Independent,49,0,49,0.04
Chepauk-Thiruvallikeni,19,NAGARAJAN,Independent,109,1,110,0.08
Chepauk-Thiruvallikeni,20,BALAJI K,Independent,34,1,35,0.03
Chepauk-Thiruvallikeni,21,BALAJI C,Independent,53,0,53,0.04
Chepauk-Thiruvallikeni,22,MANIKANDAN E,Independent,49,1,50,0.04
Chepauk-Thiruvallikeni,23,MADHANA GOPAL T,Independent,42,0,42,0.03
Chepauk-Thiruvallikeni,24,MOHAMMED HUSSAIN,Independent,33,1,34,0.02
Chepauk-Thiruvallikeni,25,MUNIYANDI,Independent,81,0,81,0.06
Chepauk-Thiruvallikeni,26,RAVI E,Independent,353,14,367,0.27
Chepauk-Thiruvallikeni,27,NOTA,None of the Above,2047,14,2061,1.5
Cheyyar,1,DUSI. K. MOHAN,All India Anna Dravida Munnetra Kazhagam,89469,720,90189,42.05
Cheyyar,2,VIJAYAKANTH. S,Bahujan Samaj Party,726,5,731,0.34
Cheyyar,3,JOTHI. O,Dravida Munnetra Kazhagam,101080,1380,102460,47.78
Cheyyar,4,KUTTIMANI. S,Veerath Thiyagi Viswanathadoss Thozhilalarkal Katchi,503,1,504,0.24
Cheyyar,5,NADARAJAN. B,New Generation People’s Party,189,1,190,0.09
Cheyyar,6,BHEEMAN. G,Naam Tamilar Katchi,12112,80,12192,5.68
Cheyyar,7,MANIKANDAN. M,Ganasangam Party of India,259,3,262,0.12
Cheyyar,8,MAYILVAGANAN. T,Makkal Needhi Maiam,2403,26,2429,1.13
Cheyyar,9,MARYVOILET. J,Desiya Sirupanmayinar Makkal Iyakkam,131,12,143,0.07
Cheyyar,10,VARADHARAJAN. M. K,Amma Makkal Munnettra Kazagam,1748,12,1760,0.82
Cheyyar,11,VENKATESAN .V,Anaithindia Samudaya Munnetra Kazhagam,100,12,112,0.05
Cheyyar,12,ANANDASEKARAN. C,Independent,286,2,288,0.13
Cheyyar,13,UDHAYAKUMAR. M,Independent,289,1,290,0.14
Cheyyar,14,SURESH BABU. T,Independent,731,2,733,0.34
Cheyyar,15,NIRMALA. V,Independent,281,1,282,0.13
Cheyyar,16,NOTA,None of the Above,1882,13,1895,0.88
Cheyyur,1,Ilayaraja S,Bahujan Samaj Party,960,4,964,0.54
Cheyyur,2,Kanitha S,All India Anna Dravida Munnetra Kazhagam,78144,564,78708,43.94
Cheyyur,3,Siva A,Desiya Murpokku Dravida Kazhagam,3026,28,3054,1.71
Cheyyur,4,Anbu Tamilsekaran P,Makkal Needhi Maiam,1927,41,1968,1.1
Cheyyur,5,Babu M,Viduthalai Chiruthaigal Katchi,81533,1217,82750,46.2
Cheyyur,6,Rajesh R,Naam Tamilar Katchi,9568,85,9653,5.39
Cheyyur,7,Amarnath B,Independent,215,1,216,0.12
Cheyyur,8,Babu E,Independent,247,16,263,0.15
Cheyyur,9,Vinoth M,Independent,402,1,403,0.22
Cheyyur,10,NOTA,None of the Above,1127,14,1141,0.64
Chidambaram,1,D. CHANDRA PRABU,Bahujan Samaj Party,474,4,478,0.26
Chidambaram,2,K.A. PANDIAN,All India Anna Dravida Munnetra Kazhagam,90523,1438,91961,50.16
Chidambaram,3,S. ABDUL RAHMAN,Indian Union Muslim League,73773,1251,75024,40.92
Chidambaram,4,K. UDAYA SELVAN,Anaithu Makkal Puratchi Katchi,304,1,305,0.17
Chidambaram,5,G. DEVASAGAYAM,Makkal Needhi Maiam,2924,29,2953,1.61
Chidambaram,6,NATARAJAN KRISHNAMOORTHY,Naam Tamilar Katchi,9021,50,9071,4.95
Chidambaram,7,M. NANTHINIDEVI,Amma Makkal Munnettra Kazagam,1380,8,1388,0.76
Chidambaram,8,M. RAGHUNATHAN,Ilantamilar Munnani Kazhagam,145,1,146,0.08
Chidambaram,9,B. NARAYANAMOORTHY,Independent,240,2,242,0.13
Chidambaram,10,S. BALAMURUGAN,Independent,335,2,337,0.18
Chidambaram,11,C. VINOBA,Independent,245,0,245,0.13
Chidambaram,12,NOTA,None of the Above,1190,12,1202,0.66
Coimbatore (North),1,AMMAN K.ARJUNAN,All India Anna Dravida Munnetra Kazhagam,80815,639,81454,40.16
Coimbatore (North),2,SHANMUGASUNDARAM V.M,Dravida Munnetra Kazhagam,76201,1252,77453,38.19
Coimbatore (North),3,APPATHURAI N.R,Amma Makkal Munnettra Kazagam,1650,9,1659,0.82
Coimbatore (North),4,RAJKUMAR M.P,Makkal Munnetra Peravai,83,3,86,0.04
Coimbatore (North),5,KANNAPIRAN V,Dravida Murpokku Makkal Katchi,128,0,128,0.06
Coimbatore (North),6,THANGAVELU R,Makkal Needhi Maiam,26335,168,26503,13.07
Coimbatore (North),7,DURAIRAJ K,Tamil Nadu Ilangyar Katchi,529,2,531,0.26
Coimbatore (North),8,PANNEER SELVARAJ M,New Generation People’s Party,135,0,135,0.07
Coimbatore (North),9,Balendran C.B,Naam Tamilar Katchi,11388,45,11433,5.64
Coimbatore (North),10,ARUL MURUGAN A,Independent,138,1,139,0.07
Coimbatore (North),11,KUMAR G.D.K,Independent,124,0,124,0.06
Coimbatore (North),12,KEERTHIGA PARTHASARATHI,Independent,245,5,250,0.12
Coimbatore (North),13,SHANMUGASUNDARAM K,Independent,55,2,57,0.03
Coimbatore (North),14,DALIT. SU. JEYARAJ,Independent,49,0,49,0.02
Coimbatore (North),15,NAVAMANI R,Independent,141,0,141,0.07
Coimbatore (North),16,BALAMURUGAN M,Independent,313,0,313,0.15
Coimbatore (North),17,BALAJI V,Independent,248,0,248,0.12
Coimbatore (North),18,MAHARISHI MANDHARACSALAM,Independent,232,1,233,0.11
Coimbatore (North),19,RAMESHKUMAR D,Independent,22,0,22,0.01
Coimbatore (North),20,LOGANATHAN M,Independent,139,1,140,0.07
Coimbatore (North),21,NOTA,None of the Above,1678,23,1701,0.84
Coimbatore (South),1,MAYURA S JAYAKUMAR,Indian National Congress,41663,720,42383,27.39
Coimbatore (South),2,ROSHAN,Bahujan Samaj Party,272,2,274,0.18
Coimbatore (South),3,VANATHI SRINIVASAN,Bharatiya Janata Party,52627,582,53209,34.38
Coimbatore (South),4,ABDUL WAHAB,Naam Tamilar Katchi,4265,35,4300,2.78
Coimbatore (South),5,KAMALHAASAN,Makkal Needhi Maiam,51087,394,51481,33.26
Coimbatore (South),6,GOPALAKRISHNAN,New Generation People’s Party,126,1,127,0.08
Coimbatore (South),7,SANMUGAVEL,Ganasangam Party of India,76,0,76,0.05
Coimbatore (South),8,DURAISAMY @ CHALLENGER DURAI,Amma Makkal Munnettra Kazagam,690,11,701,0.45
Coimbatore (South),9,RAGHUL GANDHI .K,Hindustan Janta Party,72,1,73,0.05
Coimbatore (South),10,VIVEK SUBRAMANIAM,Manitha Urimaigal Kalaagam,74,0,74,0.05
Coimbatore (South),11,VELLIMALAI,"Makkal Sananayaga Kudiyarasu Katchi,",59,0,59,0.04
Coimbatore (South),12,ALPHONSERAJ,Independent,51,0,51,0.03
Coimbatore (South),13,KUMAREASAN. K,Independent,58,0,58,0.04
Coimbatore (South),14,SUNDARAVADIVELU,Independent,190,0,190,0.12
Coimbatore (South),15,CHELLADURAI. S,Independent,29,0,29,0.02
Coimbatore (South),16,SELVAKUMAR,Independent,163,0,163,0.11
Coimbatore (South),17,DHANDABANI,Independent,181,0,181,0.12
Coimbatore (South),18,NAGAVALLI,Independent,134,1,135,0.09
Coimbatore (South),19,PALANIKUMAR.V,Independent,136,0,136,0.09
Coimbatore (South),20,JAYACHANDRAN,Independent,62,0,62,0.04
Coimbatore (South),21,JAYAPRAKASH.N,Independent,99,3,102,0.07
Coimbatore (South),22,NOTA,None of the Above,887,14,901,0.58
Colachal,1,Anish K.M.,Bahujan Samaj Party,829,2,831,0.45
Colachal,2,Sivakumar M.,Desiya Murpokku Dravida Kazhagam,1320,12,1332,0.73
Colachal,3,Prince J.G.,Indian National Congress,89121,1560,90681,49.56
Colachal,4,Ramesh P.,Bharatiya Janata Party,65047,802,65849,35.99
Colachal,5,Anthony Muthu S.M.,Communist Party of India  (Marxist-Leninist)  (Liberation),1203,15,1218,0.67
Colachal,6,Antony Aslin J.,Naam Tamilar Katchi,18071,131,18202,9.95
Colachal,7,Krishna Kumar A.,Anaithu Makkal Puratchi Katchi,1143,2,1145,0.63
Colachal,8,Raja C.,Shiv Sena,103,0,103,0.06
Colachal,9,Lathis Mary S.,Makkal Needhi Maiam,2117,10,2127,1.16
Colachal,10,"Mohammed Ali, Professor, S.",Independent,130,0,130,0.07
Colachal,11,Marystella R.,Independent,201,0,201,0.11
Colachal,12,Vijayakumar R.,Independent,270,2,272,0.15
Colachal,13,NOTA,None of the Above,870,8,878,0.48
Coonoor,1,"Prabhu Inbadass, S.",All India Trinamool Congress,399,5,404,0.3
Coonoor,2,"Ramachandran, K.",Dravida Munnetra Kazhagam,60471,1349,61820,45.49
Coonoor,3,"Vinoth, D.",All India Anna Dravida Munnetra Kazhagam,57254,461,57715,42.47
Coonoor,4,"Arumugam, R.",Anaithu Makkal Puratchi Katchi,435,4,439,0.32
Coonoor,5,"Kalaiselvan, S.",Amma Makkal Munnettra Kazagam,2499,28,2527,1.86
Coonoor,6,"Rajakumar, H.B.",Makkal Needhi Maiam,3587,34,3621,2.66
Coonoor,7,"Lavanya, M.",Naam Tamilar Katchi,7182,70,7252,5.34
Coonoor,8,"Chandran, K.",Independent,107,2,109,0.08
Coonoor,9,"Basha, A.",Independent,313,7,320,0.24
Coonoor,10,"Jayaprakash, D",Independent,509,4,513,0.38
Coonoor,11,NOTA,None of the Above,1177,11,1188,0.87
Cuddalore,1,G.IYAPPAN,Dravida Munnetra Kazhagam,82813,1750,84563,46.46
Cuddalore,2,M.C.SAMPATH,All India Anna Dravida Munnetra Kazhagam,78004,1408,79412,43.63
Cuddalore,3,A.GNANAPANDITHAN,Desiya Murpokku Dravida Kazhagam,1489,10,1499,0.82
Cuddalore,4,R.VALLAL KUMAR,Bahujan Samaj Party,78,1,79,0.04
Cuddalore,5,K.ANANDRAJ,Makkal Needhi Maiam,4005,35,4040,2.22
Cuddalore,6,S.PUSHBARAJ,Tamil Nadu Ilangyar Katchi,608,9,617,0.34
Cuddalore,7,A.Mohamed Usman,Anna Puratchi Thalaivar Amma Dravida Munnetra Kazhagam,29,0,29,0.02
Cuddalore,8,S.V.RAJARAJAN,Desiya Makkal Sakthi Katchi,74,0,74,0.04
Cuddalore,9,JALADEEPAN.V,Naam Tamilar Katchi,9480,83,9563,5.25
Cuddalore,10,G.KRISHNAN,Independent,25,4,29,0.02
Cuddalore,11,S.SAMPATH,Independent,46,0,46,0.03
Cuddalore,12,K.THANGARASU,Independent,31,0,31,0.02
Cuddalore,13,V. DAKSHNAMOORTHY,Independent,183,2,185,0.1
Cuddalore,14,S.DEENADHAYALAN,Independent,289,2,291,0.16
Cuddalore,15,J.JACOB,Independent,307,0,307,0.17
Cuddalore,16,NOTA,None of the Above,1228,8,1236,0.68
Cumbum,1,N.Ramakrishnan,Dravida Munnetra Kazhagam,102652,2148,104800,51.81
Cumbum,2,Syedukhan.S.P.M,All India Anna Dravida Munnetra Kazhagam,61978,409,62387,30.84
Cumbum,3,Anish Fathima. A,Naam Tamilar Katchi,12123,224,12347,6.1
Cumbum,4,KATHIRAVAN.S,New Generation People’s Party,232,4,236,0.12
Cumbum,5,Suresh.P,Amma Makkal Munnettra Kazagam,14399,137,14536,7.19
Cumbum,6,Pandi Selvam.R,Anna Puratchi Thalaivar Amma Dravida Munnetra Kazhagam,148,3,151,0.07
Cumbum,7,RADHAKRISHNAN.K,Anaithu Makkal Puratchi Katchi,121,1,122,0.06
Cumbum,8,Lal Bahdur Sasthri.V,My India Party,116,4,120,0.06
Cumbum,9,Venkidesh.N,Makkal Needhi Maiam,4582,65,4647,2.3
Cumbum,10,SARAVANAN.S.R,Independent,320,1,321,0.16
Cumbum,11,THAVIDHU RAJA. A,Independent,99,2,101,0.05
Cumbum,12,Prakash.P,Independent,152,3,155,0.08
Cumbum,13,MARIMUTHU.G,Independent,105,1,106,0.05
Cumbum,14,MUTHUSELVAM.G,Independent,134,2,136,0.07
Cumbum,15,MUTHU MUNEESWARAN.M,Independent,450,1,451,0.22
Cumbum,16,NOTA,None of the Above,1625,34,1659,0.82
Dharapuram,1,KAYALVIZHI N,Dravida Munnetra Kazhagam,88471,1515,89986,46.39
Dharapuram,2,MURUGAN L,Bharatiya Janata Party,87964,629,88593,45.67
Dharapuram,3,RANGASAMY S,Bahujan Samaj Party,638,2,640,0.33
Dharapuram,4,KALARANI C,Amma Makkal Munnettra Kazagam,1166,6,1172,0.6
Dharapuram,5,CHARLI A,Makkal Needhi Maiam,2114,16,2130,1.1
Dharapuram,6,CHIDAMBHARAM V,India Dravida Makkal Munnetra Katchi,123,3,126,0.06
Dharapuram,7,MUNIYAPPAN A,Anna Puratchi Thalaivar Amma Dravida Munnetra Kazhagam,220,0,220,0.11
Dharapuram,8,RANJITHA K,Naam Tamilar Katchi,6691,62,6753,3.48
Dharapuram,9,ANANTHI S,Independent,152,5,157,0.08
Dharapuram,10,KAYALVIZHI K,Independent,887,5,892,0.46
Dharapuram,11,KAYALVIZHI P,Independent,201,1,202,0.1
Dharapuram,12,KARTHIKEYAN A,Independent,157,1,158,0.08
Dharapuram,13,SELVARAJ V,Independent,233,0,233,0.12
Dharapuram,14,MURUGAN A,Independent,824,2,826,0.43
Dharapuram,15,NOTA,None of the Above,1881,22,1903,0.98
Dharmapuri,1,SUBRAMANI.P,Dravida Munnetra Kazhagam,76846,1924,78770,36.24
Dharmapuri,2,PERUMAL.P,Bahujan Samaj Party,462,2,464,0.21
Dharmapuri,3,SAKTHIVEL.P.,Desiya Makkal Sakthi Katchi,210,3,213,0.1
Dharmapuri,4,SENTHIL KUMAR (A) SENTHIL.A.,Naam Tamilar Katchi,8609,91,8700,4
Dharmapuri,5,NATARAJAN.M.,Anna Puratchi Thalaivar Amma Dravida Munnetra Kazhagam,1890,7,1897,0.87
Dharmapuri,6,MANI.L.,Dhesiya Makkal Kazhagam,194,0,194,0.09
Dharmapuri,7,RAMASAMY.T.,My India Party,208,0,208,0.1
Dharmapuri,8,RAJENDRAN.D.K.,Amma Makkal Munnettra Kazagam,11166,60,11226,5.17
Dharmapuri,9,VENKATESHWARAN.S.P.,Pattali Makkal Katchi,104415,1215,105630,48.6
Dharmapuri,10,JAYAVENKATESAN.S.K.,Makkal Needhi Maiam,5034,49,5083,2.34
Dharmapuri,11,SHANMUGAM.P.,Independent,236,1,237,0.11
Dharmapuri,12,SUNDARAMOORTHY.M.,Independent,126,1,127,0.06
Dharmapuri,13,SUBRAMANI.P.,Independent,110,0,110,0.05
Dharmapuri,14,SUBRAMANI.K.,Independent,364,0,364,0.17
Dharmapuri,15,SUBRAMANI.T.,Independent,304,0,304,0.14
Dharmapuri,16,TAMILARASAN.S.,Independent,654,0,654,0.3
Dharmapuri,17,NATARAJAN.V.,Independent,716,2,718,0.33
Dharmapuri,18,PALANI.S.K.,Independent,160,0,160,0.07
Dharmapuri,19,MANIGANDAN.E.V.,Independent,355,2,357,0.16
Dharmapuri,20,RAJENDRAN.K.,Independent,74,0,74,0.03
Dharmapuri,21,VENKATESWARAN.B.,Independent,114,3,117,0.05
Dharmapuri,22,NOTA,None of the Above,1713,13,1726,0.79
Dindigul,1,ARASUR MANOHARAN.S,Bahujan Samaj Party,492,9,501,0.26
Dindigul,2,SREENIVASAN.C,All India Anna Dravida Munnetra Kazhagam,89685,910,90595,46.43
Dindigul,3,PANDI.N,Communist Party of India  (Marxist),70393,2455,72848,37.34
Dindigul,4,AKKAMMAL.S,My India Party,301,4,305,0.16
Dindigul,5,ALAGU PANDIAN.R,Anaithu Makkal Munnetra Kazhagam,232,0,232,0.12
Dindigul,6,RAJENDRAN.R,Makkal Needhi Maiam,8950,113,9063,4.64
Dindigul,7,KARTHIKEYAN.V,Anna Puratchi Thalaivar Amma Dravida Munnetra Kazhagam,92,0,92,0.05
Dindigul,8,SIVAGANAM.A,Anaithu Makkal Puratchi Katchi,51,2,53,0.03
Dindigul,9,MURUGESAN.A,Puthiya Tamilagam,245,9,254,0.13
Dindigul,10,RAMUTHEVAR.P,Amma Makkal Munnettra Kazagam,2379,48,2427,1.24
Dindigul,11,JAYASUNDAR.R,Naam Tamilar Katchi,14703,157,14860,7.62
Dindigul,12,ANBUROSE.D,Independent,190,1,191,0.1
Dindigul,13,SENTHIL ALAGAPPAN.A,Independent,81,1,82,0.04
Dindigul,14,DHANASEKARAN.C,Independent,165,1,166,0.09
Dindigul,15,NAGARAJ.N,Independent,179,1,180,0.09
Dindigul,16,BALASUBRAMANI.K,Independent,561,9,570,0.29
Dindigul,17,BALAJI.R,Independent,104,0,104,0.05
Dindigul,18,BASKARAN CHELLAPPA.J,Independent,344,1,345,0.18
Dindigul,19,RAHAMATHULLA.M,Independent,209,1,210,0.11
Dindigul,20,VIJAYAPANDI.P,Independent,109,5,114,0.06
Dindigul,21,HARI PRAKASH.M,Independent,118,1,119,0.06
Dindigul,22,NOTA,None of the Above,1772,35,1807,0.93
Dr.Radhakrishnan Nagar,1,EBENEZER. J.J. (@)  JOHN EBENEZER.J,Dravida Munnetra Kazhagam,95516,247,95763,51.2
Dr.Radhakrishnan Nagar,2,RAAJESH.R.S.,All India Anna Dravida Munnetra Kazhagam,53204,80,53284,28.49
Dr.Radhakrishnan Nagar,3,VIJAYAN.P,Bahujan Samaj Party,361,0,361,0.19
Dr.Radhakrishnan Nagar,4,RAMADASS . E,Makkal Nalvaazhvuk Katchi,104,0,104,0.06
Dr.Radhakrishnan Nagar,5,DR. KALIDAS . P,Amma Makkal Munnettra Kazagam,1848,4,1852,0.99
Dr.Radhakrishnan Nagar,6,GOWRISHANKAR . K,Naam Tamilar Katchi,20401,36,20437,10.93
Dr.Radhakrishnan Nagar,7,SIVAKUMAR.S,SOCIALIST UNITY CENTRE OF INDIA (COMMUNIST),214,1,215,0.11
Dr.Radhakrishnan Nagar,8,FAZIL . A,Makkal Needhi Maiam,11181,17,11198,5.99
Dr.Radhakrishnan Nagar,9,BABU MAILAN . A,Republican Party of India (Athawale),115,0,115,0.06
Dr.Radhakrishnan Nagar,10,MOHAN . R,United States of India Party,79,0,79,0.04
Dr.Radhakrishnan Nagar,11,VENUGOPAL.D,Shiv Sena,32,2,34,0.02
Dr.Radhakrishnan Nagar,12,ETHIRAJ.R,Independent,26,0,26,0.01
Dr.Radhakrishnan Nagar,13,KANDEEPAN.G,Independent,111,0,111,0.06
Dr.Radhakrishnan Nagar,14,KALIDASS,Independent,67,0,67,0.04
Dr.Radhakrishnan Nagar,15,GUNASEKARAN.G,Independent,92,0,92,0.05
Dr.Radhakrishnan Nagar,16,SASIDARAN.S,Independent,241,0,241,0.13
Dr.Radhakrishnan Nagar,17,SANTHAKUMAR . A,Independent,557,0,557,0.3
Dr.Radhakrishnan Nagar,18,Daniel Sachin Mani.E,Independent,222,0,222,0.12
Dr.Radhakrishnan Nagar,19,DEVAKUMAR.R,Independent,48,0,48,0.03
Dr.Radhakrishnan Nagar,20,DEVARAJ.M,Independent,48,0,48,0.03
Dr.Radhakrishnan Nagar,21,FRANKLIN.D,Independent,44,0,44,0.02
Dr.Radhakrishnan Nagar,22,PREMKUMAR.P,Independent,79,0,79,0.04
Dr.Radhakrishnan Nagar,23,PURUSHOTHAMAN . K,Independent,44,0,44,0.02
Dr.Radhakrishnan Nagar,24,BOOTHIRAJAN.G,Independent,39,0,39,0.02
Dr.Radhakrishnan Nagar,25,MADHAN RAJ . D,Independent,22,0,22,0.01
Dr.Radhakrishnan Nagar,26,MARIMUTHU.P,Independent,38,0,38,0.02
Dr.Radhakrishnan Nagar,27,RAJESH . I,Independent,47,0,47,0.03
Dr.Radhakrishnan Nagar,28,RAJESH . S,Independent,36,1,37,0.02
Dr.Radhakrishnan Nagar,29,VIVEK.C,Independent,27,0,27,0.01
Dr.Radhakrishnan Nagar,30,VENKATRAMAN . C,Independent,36,1,37,0.02
Dr.Radhakrishnan Nagar,31,SRIDHAR . C,Independent,55,0,55,0.03
Dr.Radhakrishnan Nagar,32,NOTA,None of the Above,1702,2,1704,0.91
Edappadi,1,SAMBATHKUMAR. T,Dravida Munnetra Kazhagam,68082,1270,69352,28.04
Edappadi,2,EDAPPADI PALANISWAMI. K,All India Anna Dravida Munnetra Kazhagam,160931,2223,163154,65.97
Edappadi,3,JAMUNA. A,Bahujan Samaj Party,813,2,815,0.33
Edappadi,4,SOCIAL WORKER ESWARI. P,Ambedkarite Party of India,132,3,135,0.05
Edappadi,5,GUNASEKARAN. K.N,My India Party,117,1,118,0.05
Edappadi,6,SURIYAMOORTHY. S,MGR Makkal Katchi,64,0,64,0.03
Edappadi,7,THASAPPARAJ. D,Makkal Needhi Maiam,1532,15,1547,0.63
Edappadi,8,POOKADAI SEKAR. N,Amma Makkal Munnettra Kazagam,764,10,774,0.31
Edappadi,9,MANI. C,Dhesiya Makkal Kazhagam,46,1,47,0.02
Edappadi,10,MANIKANDAN. R,Tamil Nadu Ilangyar Katchi,147,6,153,0.06
Edappadi,11,SHRI RATHNA,Naam Tamilar Katchi,6574,52,6626,2.68
Edappadi,12,AGNI SRI RAMACHANDRAN. N,Independent,259,2,261,0.11
Edappadi,13,ESWARAMURTHY. N,Independent,89,0,89,0.04
Edappadi,14,ESWARAMOORTHY P,Independent,165,1,166,0.07
Edappadi,15,IYYAPPAN. P,Independent,483,0,483,0.2
Edappadi,16,KATHIRAVAN. V,Independent,555,0,555,0.22
Edappadi,17,KATHIRESAN. L,Independent,407,0,407,0.16
Edappadi,18,GUHESHKUMAR. M,Independent,474,0,474,0.19
Edappadi,19,SHANMUGAM. G,Independent,66,0,66,0.03
Edappadi,20,SOWNTHARARAJAN. G,Independent,44,0,44,0.02
Edappadi,21,DR. PADMARAJAN. K,Independent,35,1,36,0.01
Edappadi,22,PALANISAMY. A,Independent,26,0,26,0.01
Edappadi,23,BALASUBRAMANIAM. J,Independent,60,1,61,0.02
Edappadi,24,BALAMURUGAN. M,Independent,39,0,39,0.02
Edappadi,25,MURUGAN. M,Independent,90,1,91,0.04
Edappadi,26,LAKSHMI. G,Independent,199,0,199,0.08
Edappadi,27,LOGANATHAN. S,Independent,208,0,208,0.08
Edappadi,28,STALIN. A,Independent,202,0,202,0.08
Edappadi,29,NOTA,None of the Above,1091,18,1109,0.45
Egmore,1,K.P.SUNDARAPRATHABAN,Bahujan Samaj Party,357,4,361,0.3
Egmore,2,I.PARANTHAMEN,Dravida Munnetra Kazhagam,68160,672,68832,57.71
Egmore,3,T.PRABHU,Desiya Murpokku Dravida Kazhagam,1270,23,1293,1.08
Egmore,4,B.JOHN PANDIAN,All India Anna Dravida Munnetra Kazhagam,29729,335,30064,25.21
Egmore,5,P.GEETHA LAKSHMI,Naam Tamilar Katchi,6237,39,6276,5.26
Egmore,6,J.CHANDRAKALA,Lok Jan Shakti Party,91,1,92,0.08
Egmore,7,U. PRIYADARSINI,Makkal Needhi Maiam,9933,57,9990,8.38
Egmore,8,R.REVANTH,Anaithu Makkal Arasiyal Katchi,45,0,45,0.04
Egmore,9,G.SHEEJA,Nam India Naam Indiyar Katchi,55,0,55,0.05
Egmore,10,N.ARAVINTH KUMAR,Independent,38,0,38,0.03
Egmore,11,V.ESWARAN,Independent,22,4,26,0.02
Egmore,12,M.UTHAYAKUMAR,Independent,39,2,41,0.03
Egmore,13,Dr.N. GUNASEKAR,Independent,107,2,109,0.09
Egmore,14,V.SEKAR,Independent,26,2,28,0.02
Egmore,15,A.PARANTHAMAN,Independent,98,0,98,0.08
Egmore,16,V. PRABHU,Independent,491,1,492,0.41
Egmore,17,G.R.RAJENDRAN,Independent,82,2,84,0.07
Egmore,18,S.JAYAKALPANA,Independent,171,0,171,0.14
Egmore,19,NOTA,None of the Above,1167,9,1176,0.99
Erode (East),1,"GOVINDARAJ,S.",Bahujan Samaj Party,366,6,372,0.24
Erode (East),2,"THIRUMAHAN EVERAA,E.",Indian National Congress,66497,803,67300,44.27
Erode (East),3,"YUVARAJA,M.",All India Anna Dravida Munnetra Kazhagam,58097,299,58396,38.41
Erode (East),4,ARUMUGA AC KANNAN,Ambedkarite Party of India,373,0,373,0.25
Erode (East),5,"GOMATHI,S.",Naam Tamilar Katchi,11575,54,11629,7.65
Erode (East),6,"SHANMUGAVEL,S.",MGR Makkal Katchi,150,1,151,0.1
Erode (East),7,"MUTHUKUMARAN,S.A.",Amma Makkal Munnettra Kazagam,1197,7,1204,0.79
Erode (East),8,"RAJA,P.","Makkal Thilagam Munnetra Kazhagam,",100,2,102,0.07
Erode (East),9,"RAJAKUMAR,A.M.R",Makkal Needhi Maiam,9966,39,10005,6.58
Erode (East),10,"ANTONY PETER,L.",Independent,95,1,96,0.06
Erode (East),11,"MINNAL MURUGESH,R.",Independent,72,1,73,0.05
Erode (East),12,"MEENAKSHI,V.",Independent,296,3,299,0.2
Erode (East),13,"YUVARAJ,M.",Independent,234,1,235,0.15
Erode (East),14,"SHAJAHAN,I.",Independent,256,0,256,0.17
Erode (East),15,NOTA,None of the Above,1530,16,1546,1.02
Erode (West),1,Ramalingam K V,All India Anna Dravida Munnetra Kazhagam,78200,468,78668,38.27
Erode (West),2,Dhanalakshmi A,Bahujan Samaj Party,568,0,568,0.28
Erode (West),3,Muthusamy S,Dravida Munnetra Kazhagam,99032,1725,100757,49.01
Erode (West),4,Chandra kumar P,Naam Tamilar Katchi,13297,56,13353,6.5
Erode (West),5,Chandran M,Ambedkarite Party of India,113,0,113,0.05
Erode (West),6,Sivasubramaniyan S,Amma Makkal Munnettra Kazagam,728,2,730,0.36
Erode (West),7,Thangavel G,United States of India Party,106,3,109,0.05
Erode (West),8,Durai Sevugan,Makkal Needhi Maiam,8068,39,8107,3.94
Erode (West),9,Balasubramaniam K,India Dravida Makkal Munnetra Katchi,54,0,54,0.03
Erode (West),10,Madhan K,Ganasangam Party of India,108,0,108,0.05
Erode (West),11,Iyyavu R,Independent,71,2,73,0.04
Erode (West),12,Kalithass R,Independent,166,3,169,0.08
Erode (West),13,Muthusamy A,Independent,189,0,189,0.09
Erode (West),14,Vimala M,Independent,432,2,434,0.21
Erode (West),15,VENGATESAN A,Independent,177,2,179,0.09
Erode (West),16,NOTA,None of the Above,1954,14,1968,0.96
Gandarvakkottai,1,M.Chinnadurai,Communist Party of India  (Marxist),68715,995,69710,44.23
Gandarvakkottai,2,S.Jayabharathi,All India Anna Dravida Munnetra Kazhagam,56681,308,56989,36.16
Gandarvakkottai,3,P.Asaithambi,Communist Party of India  (Marxist-Leninist)  (Liberation),1260,11,1271,0.81
Gandarvakkottai,4,KRM.Adhidravidar,Makkal Needhi Maiam,843,5,848,0.54
Gandarvakkottai,5,M.Thanaraj,Namadhu Makkal Katchi,133,0,133,0.08
Gandarvakkottai,6,S.Malarvizhi,Anaithu Makkal Arasiyal Katchi,188,2,190,0.12
Gandarvakkottai,7,M.Ramila,Naam Tamilar Katchi,12606,55,12661,8.03
Gandarvakkottai,8,P.Lenin,Amma Makkal Munnettra Kazagam,12728,112,12840,8.15
Gandarvakkottai,9,V.Ilaiyaraja,Independent,129,1,130,0.08
Gandarvakkottai,10,P.Karthikeyan,Independent,286,3,289,0.18
Gandarvakkottai,11,Keerai.A.T.Chinnappa,Independent,109,2,111,0.07
Gandarvakkottai,12,K. Manimuthu,Independent,231,1,232,0.15
Gandarvakkottai,13,P.Rengasamy,Independent,206,0,206,0.13
Gandarvakkottai,14,V.Rethinam,Independent,620,0,620,0.39
Gandarvakkottai,15,NOTA,None of the Above,1384,6,1390,0.88
Gangavalli,1,"SELLAMMAL,V.M.",Bahujan Samaj Party,481,4,485,0.26
Gangavalli,2,"NALLATHAMBI,A.",All India Anna Dravida Munnetra Kazhagam,88900,668,89568,48.02
Gangavalli,3,"REKHA PRIYADHARSHINI,J.",Dravida Munnetra Kazhagam,80466,1741,82207,44.08
Gangavalli,4,"NAVAN,P.",Puthiya Tamilagam,603,6,609,0.33
Gangavalli,5,"PANDIAN,A.",Amma Makkal Munnettra Kazagam,1497,22,1519,0.81
Gangavalli,6,"PERIYASAMY,K.",Indiya Jananayaka Katchi,488,5,493,0.26
Gangavalli,7,"VINOTHINI,R.",Naam Tamilar Katchi,9241,82,9323,5
Gangavalli,8,"AYYADURAI,J.",Independent,104,1,105,0.06
Gangavalli,9,"CHANDRASEKARAN,K.",Independent,155,0,155,0.08
Gangavalli,10,"SARAVANAN,R.",Independent,396,0,396,0.21
Gangavalli,11,"SENTHILKUMAR,K.",Independent,392,0,392,0.21
Gangavalli,12,NOTA,None of the Above,1241,10,1251,0.67
Gingee,1,MASTHAN K S,Dravida Munnetra Kazhagam,107683,1942,109625,52.99
Gingee,2,JAGAJANANDAM  R,Bahujan Samaj Party,632,5,637,0.31
Gingee,3,ELUMALAI N A,Anna Dravidar Kazhagam,401,9,410,0.2
Gingee,4,GOWTHAM SAGAR A,Amma Makkal Munnettra Kazagam,4751,60,4811,2.33
Gingee,5,SUGUMAR AP,Naam Tamilar Katchi,9860,60,9920,4.8
Gingee,6,RAJENDIRAN P,Pattali Makkal Katchi,73078,744,73822,35.68
Gingee,7,SRIPATHI P,Makkal Needhi Maiam,2137,14,2151,1.04
Gingee,8,KIRUBAKARAN T,Independent,179,2,181,0.09
Gingee,9,GOPI S,Independent,1911,3,1914,0.93
Gingee,10,SAHEERA,Independent,167,1,168,0.08
Gingee,11,SENJIRAJA KNK,Independent,156,1,157,0.08
Gingee,12,MARIYAPPAN S,Independent,245,1,246,0.12
Gingee,13,VARTHAMANAN B,Independent,554,5,559,0.27
Gingee,14,NOTA,None of the Above,2275,4,2279,1.1
Gobichettipalayam,1,SENGOTTAIYAN K.A,All India Anna Dravida Munnetra Kazhagam,107571,1037,108608,50.68
Gobichettipalayam,2,PALANISAMY P,Bahujan Samaj Party,1027,7,1034,0.48
Gobichettipalayam,3,MANIMARAN G.V,Dravida Munnetra Kazhagam,78488,1557,80045,37.36
Gobichettipalayam,4,SAKTHIVEL G,India Dravida Makkal Munnetra Katchi,412,3,415,0.19
Gobichettipalayam,5,SEETHALAKSHMI M.K,Naam Tamilar Katchi,11661,58,11719,5.47
Gobichettipalayam,6,THULASIMANI N.K,Amma Makkal Munnettra Kazagam,2653,29,2682,1.25
Gobichettipalayam,7,PRAKASH N.K,Makkal Needhi Maiam,4258,33,4291,2
Gobichettipalayam,8,KUMAR D,Independent,128,2,130,0.06
Gobichettipalayam,9,SANKARKUMAR K.A,Independent,157,0,157,0.07
Gobichettipalayam,10,SELVAKKUMAR S,Independent,77,0,77,0.04
Gobichettipalayam,11,DHANABAL K,Independent,310,1,311,0.15
Gobichettipalayam,12,DEVARAJ N,Independent,305,2,307,0.14
Gobichettipalayam,13,PALANISAMYRAAJ M,Independent,426,4,430,0.2
Gobichettipalayam,14,BOOPATHIRAJA  A.N,Independent,418,0,418,0.2
Gobichettipalayam,15,MUTHUMANI P,Independent,296,0,296,0.14
Gobichettipalayam,16,MOHANRAJ K,Independent,789,0,789,0.37
Gobichettipalayam,17,RAKKIMUTHU RANGANADAR R,Independent,611,0,611,0.29
Gobichettipalayam,18,JUNAYATH M,Independent,178,0,178,0.08
Gobichettipalayam,19,SRIDEVI R,Independent,473,3,476,0.22
Gobichettipalayam,20,NOTA,None of the Above,1295,12,1307,0.61
Gudalur,1,"KASILINGAM, S.",Dravida Munnetra Kazhagam,61564,987,62551,45.24
Gudalur,2,PON.JAYASEELAN,All India Anna Dravida Munnetra Kazhagam,63810,686,64496,46.65
Gudalur,3,"YOGESWARAN, A.",Desiya Murpokku Dravida Kazhagam,1160,13,1173,0.85
Gudalur,4,"KETHEESWARAN, R.",Naam Tamilar Katchi,7252,65,7317,5.29
Gudalur,5,"BABU, J.",Makkal Needhi Maiam,950,10,960,0.69
Gudalur,6,"JAYAPRAKASH, P.",Tamilaga Makkal Thannurimai Katchi,321,1,322,0.23
Gudalur,7,"SARAVANAN, M.",Independent,417,4,421,0.3
Gudalur,8,NOTA,None of the Above,1003,14,1017,0.74
Gudiyattam,1,Amulu.V,Dravida Munnetra Kazhagam,99525,887,100412,47.45
Gudiyattam,2,Paritha.G,All India Anna Dravida Munnetra Kazhagam,93066,445,93511,44.19
Gudiyattam,3,Raja.S,Bahujan Samaj Party,502,3,505,0.24
Gudiyattam,4,Kalaiyenthiri.R,Naam Tamilar Katchi,11776,58,11834,5.59
Gudiyattam,5,Selvavinayagam.D,All Pensioner’s Party,117,2,119,0.06
Gudiyattam,6,Rajan.C,Indiya Jananayaka Katchi,477,5,482,0.23
Gudiyattam,7,Vennila.R,Republican Party of India (Athawale),65,2,67,0.03
Gudiyattam,8,Jayanthi Padmanaban.C,Amma Makkal Munnettra Kazagam,1793,17,1810,0.86
Gudiyattam,9,Elumalai.M,Independent,166,2,168,0.08
Gudiyattam,10,Gunaseelan.P,Independent,137,0,137,0.06
Gudiyattam,11,Priya.M,Independent,60,2,62,0.03
Gudiyattam,12,Manojkumar.G,Independent,52,0,52,0.02
Gudiyattam,13,Radha,Independent,66,0,66,0.03
Gudiyattam,14,Lakshmipathy.N,Independent,255,2,257,0.12
Gudiyattam,15,Jaikarthikeyan.K,Independent,448,1,449,0.21
Gudiyattam,16,NOTA,None of the Above,1691,8,1699,0.8
Gummidipoondi,1,GOVINDARAJAN T.J,Dravida Munnetra Kazhagam,125001,1451,126452,56.94
Gummidipoondi,2,DILLIY K.M,Desiya Murpokku Dravida Kazhagam,2553,23,2576,1.16
Gummidipoondi,3,NAGARAJ S,Bahujan Samaj Party,1031,7,1038,0.47
Gummidipoondi,4,USHA,Naam Tamilar Katchi,11643,58,11701,5.27
Gummidipoondi,5,GOWTHAM J,Anaithu Makkal Arasiyal Katchi,254,0,254,0.11
Gummidipoondi,6,SARAVANAN V,Indiya Jananayaka Katchi,813,3,816,0.37
Gummidipoondi,7,PRAKASH M,Pattali Makkal Katchi,75004,510,75514,34
Gummidipoondi,8,SARAVANAN E,Independent,526,6,532,0.24
Gummidipoondi,9,DEVANATHAN R,Independent,482,0,482,0.22
Gummidipoondi,10,PRAKASH K,Independent,349,2,351,0.16
Gummidipoondi,11,PRAKASH M,Independent,196,0,196,0.09
Gummidipoondi,12,LAKSHMI R,Independent,369,5,374,0.17
Gummidipoondi,13,NOTA,None of the Above,1775,8,1783,0.8
Harbour,1,SEKARBABU. P.K,Dravida Munnetra Kazhagam,59073,244,59317,58.35
Harbour,2,RAVIKUMAR. C,Bahujan Samaj Party,410,0,410,0.4
Harbour,3,VINOJ. P. SELVAM,Bharatiya Janata Party,31971,72,32043,31.52
Harbour,4,AHAMED FAZIL. M,Naam Tamilar Katchi,3345,12,3357,3.3
Harbour,5,SANTHANA KRISHNAN. P,Amma Makkal Munnettra Kazagam,771,4,775,0.76
Harbour,6,RAMESH. A,Makkal Needhi Maiam,3758,5,3763,3.7
Harbour,7,ANANDRAJ. T.K,Independent,21,0,21,0.02
Harbour,8,UDHAYAKUMAR. V,Independent,25,0,25,0.02
Harbour,9,GANESH. S,Independent,68,0,68,0.07
Harbour,10,KAMAL. J,Independent,45,2,47,0.05
Harbour,11,KRISHNAKUMAR. G,Independent,22,0,22,0.02
Harbour,12,SHANKAR. A,Independent,37,1,38,0.04
Harbour,13,CHANDRAN. R,Independent,13,0,13,0.01
Harbour,14,SIVARAMAN. G,Independent,40,0,40,0.04
Harbour,15,ZIONRAJ. M,Independent,18,0,18,0.02
Harbour,16,SURESH. R,Independent,117,0,117,0.12
Harbour,17,SELVAM. P,Independent,247,0,247,0.24
Harbour,18,SELVAKUMAR. R,Independent,37,0,37,0.04
Harbour,19,SELVARAJ. S,Independent,63,0,63,0.06
Harbour,20,DAMODHARAN. A.G,Independent,20,0,20,0.02
Harbour,21,NAGARAJ. S,Independent,10,0,10,0.01
Harbour,22,PUGALENTHI. P,Independent,28,0,28,0.03
Harbour,23,MAHALINGAM. D,Independent,10,0,10,0.01
Harbour,24,RAGHUNATH. K,Independent,13,0,13,0.01
Harbour,25,RAMESH. D,Independent,11,1,12,0.01
Harbour,26,RAMKI. P,Independent,33,0,33,0.03
Harbour,27,VIVEK RAM. A,Independent,166,0,166,0.16
Harbour,28,SRINIVASAN. P,Independent,25,0,25,0.02
Harbour,29,NOTA,None of the Above,909,3,912,0.9
Harur,1,KUMAR.A,Communist Party of India  (Marxist),67358,1341,68699,34.6
Harur,2,SAMPATHKUMAR.V,All India Anna Dravida Munnetra Kazhagam,98130,931,99061,49.89
Harur,3,SIVAKUMAR.A,Bahujan Samaj Party,920,0,920,0.46
Harur,4,KARUTHOVIYAM.P,My India Party,377,5,382,0.19
Harur,5,KEERTHANA.K,Naam Tamilar Katchi,10830,120,10950,5.51
Harur,6,SATHISKUMAR.S,Indiya Jananayaka Katchi,275,7,282,0.14
Harur,7,CHINNASAMY.K,Dhesiya Makkal Kazhagam,168,1,169,0.09
Harur,8,MURUGAN.R,Amma Makkal Munnettra Kazagam,14161,166,14327,7.22
Harur,9,KUMAR.P,Independent,263,2,265,0.13
Harur,10,SARATHKUMAR.M,Independent,153,1,154,0.08
Harur,11,PALANI.C,Independent,172,1,173,0.09
Harur,12,PARTHIPAN.P,Independent,409,4,413,0.21
Harur,13,MURUGAN.R,Independent,520,1,521,0.26
Harur,14,NOTA,None of the Above,2232,17,2249,1.13
Hosur,1,PRAKAASH Y,Dravida Munnetra Kazhagam,117199,1032,118231,47.65
Hosur,2,JYOTHI S,All India Anna Dravida Munnetra Kazhagam,105475,389,105864,42.67
Hosur,3,EZHILAN S,Veerath Thiyagi Viswanathadoss Thozhilalarkal Katchi,460,2,462,0.19
Hosur,4,GEETHA LAKSHMI S,Naam Tamilar Katchi,11391,31,11422,4.6
Hosur,5,SUNDAR L,Shiv Sena,127,0,127,0.05
Hosur,6,SELVAM G,New Generation People’s Party,145,0,145,0.06
Hosur,7,MASOOD S,Makkal Needhi Maiam,6536,27,6563,2.65
Hosur,8,MAREGOWDU M,Amma Makkal Munnettra Kazagam,806,0,806,0.32
Hosur,9,JAYASEELAN G,Anna Puratchi Thalaivar Amma Dravida Munnetra Kazhagam,64,1,65,0.03
Hosur,10,KISHORE KUMAR R,Independent,54,0,54,0.02
Hosur,11,GEETHA V,Independent,72,1,73,0.03
Hosur,12,SHANMUGAM R,Independent,124,1,125,0.05
Hosur,13,DEVAPPA Y,Independent,80,1,81,0.03
Hosur,14,BALARAJU N,Independent,132,0,132,0.05
Hosur,15,MUTHAMIZH MUDHALVAN S,Independent,395,2,397,0.16
Hosur,16,MUTHU R K,Independent,585,0,585,0.24
Hosur,17,RAMASWAMY G C,Independent,628,1,629,0.25
Hosur,18,LOKESH V,Independent,361,0,361,0.15
Hosur,19,NOTA,None of the Above,1968,8,1976,0.8
Jayankondam,1,KANNAN KA SO KA,Dravida Munnetra Kazhagam,98174,1355,99529,46
Jayankondam,2,NEELAMEGAM K,Bahujan Samaj Party,603,2,605,0.28
Jayankondam,3,SIVA J K,Amma Makkal Munnettra Kazagam,1545,15,1560,0.72
Jayankondam,4,SORNALATHA @ LATHA G,Indiya Jananayaka Katchi,4662,38,4700,2.17
Jayankondam,5,NATARAJAN A,Anna Dravidar Kazhagam,413,5,418,0.19
Jayankondam,6,BALU K,Pattali Makkal Katchi,93217,860,94077,43.48
Jayankondam,7,MAHALINGAM NEELA,Naam Tamilar Katchi,9903,53,9956,4.6
Jayankondam,8,KESAVARAJAN V K,Independent,1543,3,1546,0.71
Jayankondam,9,SATHISHKUMAR R,Independent,348,1,349,0.16
Jayankondam,10,SAMUVEL MARTIN A,Independent,309,3,312,0.14
Jayankondam,11,SUDARVIZHI K,Independent,247,3,250,0.12
Jayankondam,12,SEDHURAMAN R,Independent,257,1,258,0.12
Jayankondam,13,RAJKUMAR S,Independent,945,2,947,0.44
Jayankondam,14,NOTA,None of the Above,1850,11,1861,0.86
Jolarpet,1,SIVAKUMAR.V.C.,Bahujan Samaj Party,341,6,347,0.18
Jolarpet,2,DEVARAJI.K.,Dravida Munnetra Kazhagam,88237,1253,89490,45.57
Jolarpet,3,VEERAMANI.K.C.,All India Anna Dravida Munnetra Kazhagam,87365,1034,88399,45.02
Jolarpet,4,KALASTHRI.S.,All India Uzhavargal Uzhaippalargal Katchi,861,9,870,0.44
Jolarpet,5,SIVA.A.,Naam Tamilar Katchi,13199,129,13328,6.79
Jolarpet,6,THENNARASU SAAMRAJ,Amma Makkal Munnettra Kazagam,614,5,619,0.32
Jolarpet,7,KARUNANIDHI.R.,Independent,1057,10,1067,0.54
Jolarpet,8,DEVARAJI.R.,Independent,101,2,103,0.05
Jolarpet,9,DEVARAJ.V.K.,Independent,80,2,82,0.04
Jolarpet,10,MANITHAN,Independent,140,2,142,0.07
Jolarpet,11,VEERAMANI.A.,Independent,148,0,148,0.08
Jolarpet,12,VEERAMANI.H.,Independent,208,1,209,0.11
Jolarpet,13,VEERAMANI.S.,Independent,217,0,217,0.11
Jolarpet,14,NOTA,None of the Above,1328,9,1337,0.68
Kadayanallur,1,C.KRISHNAMURALI,All India Anna Dravida Munnetra Kazhagam,87900,574,88474,43.08
Kadayanallur,2,M.AMBIKADEVI,Makkal Needhi Maiam,1756,22,1778,0.87
Kadayanallur,3,S.AYYADURAIPANDIAN,Amma Makkal Munnettra Kazagam,34047,169,34216,16.66
Kadayanallur,4,S.RAJA RAM,New Generation People’s Party,313,5,318,0.15
Kadayanallur,5,M.MUTHULAKSHMI,Naam Tamilar Katchi,10052,84,10136,4.94
Kadayanallur,6,K.A.M.MUHAMMED ABUBACKER,Indian Union Muslim League,63298,827,64125,31.22
Kadayanallur,7,M.AYYADURAI,Independent,283,1,284,0.14
Kadayanallur,8,AYYADURAI  R,Independent,87,0,87,0.04
Kadayanallur,9,AVANI RAJA.T,Independent,80,0,80,0.04
Kadayanallur,10,K.RADHA KRISHNAN,Independent,84,1,85,0.04
Kadayanallur,11,RAJA PONNUSAMY,Independent,257,2,259,0.13
Kadayanallur,12,A.GANESAN,Independent,117,5,122,0.06
Kadayanallur,13,R.KRISHNAN,Independent,126,0,126,0.06
Kadayanallur,14,A.SANKAR,Independent,413,0,413,0.2
Kadayanallur,15,SIVASUBRAMANIYAN R,Independent,666,6,672,0.33
Kadayanallur,16,S.SEENIVASAN,Independent,938,0,938,0.46
Kadayanallur,17,POOLOGARAJ R,Independent,657,1,658,0.32
Kadayanallur,18,MARIDURAIPANDIAN,Independent,96,0,96,0.05
Kadayanallur,19,S.MURUGANANTHAM,Independent,532,0,532,0.26
Kadayanallur,20,P.RAJI,Independent,245,2,247,0.12
Kadayanallur,21,VELAMMAL,Independent,670,2,672,0.33
Kadayanallur,22,NOTA,None of the Above,1047,9,1056,0.51
Kalasapakkam,1,Saravanan.P.S.T,Dravida Munnetra Kazhagam,92712,1422,94134,47.92
Kalasapakkam,2,Nehru.M,Desiya Murpokku Dravida Kazhagam,2738,18,2756,1.4
Kalasapakkam,3,Panneerselvam.V,All India Anna Dravida Munnetra Kazhagam,84070,842,84912,43.23
Kalasapakkam,4,Rajkumar.E,Bahujan Samaj Party,623,9,632,0.32
Kalasapakkam,5,Kalyanasundaram.A,Veerath Thiyagi Viswanathadoss Thozhilalarkal Katchi,126,2,128,0.07
Kalasapakkam,6,Sampath.R.V,Anna Dravidar Kazhagam,91,1,92,0.05
Kalasapakkam,7,Balaji.E,Naam Tamilar Katchi,8748,74,8822,4.49
Kalasapakkam,8,Rajendran.M.S,Indiya Jananayaka Katchi,239,5,244,0.12
Kalasapakkam,9,Amutha.G,Independent,362,20,382,0.19
Kalasapakkam,10,Saravanan.K,Independent,244,6,250,0.13
Kalasapakkam,11,Tirunavukarasu.M,Independent,755,10,765,0.39
Kalasapakkam,12,Panneerselvam.S,Independent,710,3,713,0.36
Kalasapakkam,13,Panneerselvam.V,Independent,238,1,239,0.12
Kalasapakkam,14,Rajamani.K,Independent,449,1,450,0.23
Kalasapakkam,15,Jagannathan.R,Independent,321,1,322,0.16
Kalasapakkam,16,NOTA,None of the Above,1584,9,1593,0.81
Kallakurichi,1,Suriyaprakash.M,Independent,655,4,659,0.29
Kallakurichi,2,Dravidamuthamilselvi.D,Naam Tamilar Katchi,16409,65,16474,7.29
Kallakurichi,3,Manirathinem.K.I,Indian National Congress,83367,1385,84752,37.52
Kallakurichi,4,Vijayakumar.N,Desiya Murpokku Dravida Kazhagam,6555,16,6571,2.91
Kallakurichi,5,Senthilkumar.M,All India Anna Dravida Munnetra Kazhagam,109909,734,110643,48.99
Kallakurichi,6,Dinesh.M,My India Party,197,1,198,0.09
Kallakurichi,7,Ayyasamy.M,Indiya Jananayaka Katchi,864,7,871,0.39
Kallakurichi,8,Devimangayarkarasi.K,Independent,1197,0,1197,0.53
Kallakurichi,9,Prabu.C,Independent,937,0,937,0.41
Kallakurichi,10,Gurusamy.M,Independent,103,0,103,0.05
Kallakurichi,11,Selvaraj.M,Independent,265,1,266,0.12
Kallakurichi,12,Palanisamy.A,Bahujan Samaj Party,1096,1,1097,0.49
Kallakurichi,13,Kuppusamy.K,Anna MGR Dravida Makkal Kalgam,171,0,171,0.08
Kallakurichi,14,Oviyar Ananth,Lok Jan Shakti Party,102,0,102,0.05
Kallakurichi,15,Elaiyaperumal.K,Independent,185,0,185,0.08
Kallakurichi,16,Sivakumar.S,Independent,125,0,125,0.06
Kallakurichi,17,Subramaniyan.P,Independent,248,2,250,0.11
Kallakurichi,18,NOTA,None of the Above,1247,10,1257,0.56
Kancheepuram,1,C.V.M.P. Ezhailzrasan,Dravida Munnetra Kazhagam,100914,1798,102712,44.77
Kancheepuram,2,K. Prabakaran,Bahujan Samaj Party,1185,8,1193,0.52
Kancheepuram,3,B. GOPINATH,Makkal Needhi Maiam,11936,92,12028,5.24
Kancheepuram,4,S. SALDIN,Naam Tamilar Katchi,13829,117,13946,6.08
Kancheepuram,5,P. Magesh Kumar,Pattali Makkal Katchi,90390,727,91117,39.71
Kancheepuram,6,N. MANOGARAN,Amma Makkal Munnettra Kazagam,2283,18,2301,1
Kancheepuram,7,M. MEGANATHAN,New Generation People’s Party,241,7,248,0.11
Kancheepuram,8,L. ARULNATHAN,Independent,2024,26,2050,0.89
Kancheepuram,9,M.ELANGOVAN,Independent,94,17,111,0.05
Kancheepuram,10,P. EZHILARASAN,Independent,126,1,127,0.06
Kancheepuram,11,S. SRINIVASAN,Independent,162,0,162,0.07
Kancheepuram,12,D.GNANAMOORTHY,Independent,412,3,415,0.18
Kancheepuram,13,T. MAGESH,Independent,143,14,157,0.07
Kancheepuram,14,R. VINOTHRAJ,Independent,133,0,133,0.06
Kancheepuram,15,J. JAYARAJ,Independent,192,1,193,0.08
Kancheepuram,16,NOTA,None of the Above,2521,18,2539,1.11
Kangayam,1,AYYAVU.N,Bahujan Samaj Party,421,0,421,0.21
Kangayam,2,SAMINATHAN.M.P,Dravida Munnetra Kazhagam,93178,1019,94197,47.14
Kangayam,3,RAMALINGAM.A.S,All India Anna Dravida Munnetra Kazhagam,86477,389,86866,43.47
Kangayam,4,SIVANANTHAM.K,Naam Tamilar Katchi,11248,59,11307,5.66
Kangayam,5,MANOHARAN.S,Anna Puratchi Thalaivar Amma Dravida Munnetra Kazhagam,134,0,134,0.07
Kangayam,6,RAMESH.C,Amma Makkal Munnettra Kazagam,474,0,474,0.24
Kangayam,7,APPASAMY.R,Independent,2317,10,2327,1.16
Kangayam,8,IMMANUVEL.R,Independent,434,1,435,0.22
Kangayam,9,GOPINATH.P,Independent,247,0,247,0.12
Kangayam,10,SATHISH KUMAR.P,Independent,60,2,62,0.03
Kangayam,11,SATHYAMOORTHI.S,Independent,106,1,107,0.05
Kangayam,12,SUKUMARAN.N,Independent,59,0,59,0.03
Kangayam,13,SUBRAMANIAN.D,Independent,123,1,124,0.06
Kangayam,14,SELVAKUMAR.K,Independent,225,0,225,0.11
Kangayam,15,NALLAMUTHU.P,Independent,276,0,276,0.14
Kangayam,16,NITHIYANDHAN.C,Independent,285,0,285,0.14
Kangayam,17,PRABHAKARAN.G,Independent,113,0,113,0.06
Kangayam,18,MANI.A,Independent,273,0,273,0.14
Kangayam,19,MANIKANDAN.R,Independent,330,0,330,0.17
Kangayam,20,RAVIKUMAR.R,Independent,98,2,100,0.05
Kangayam,21,RAMALINGAM.N,Independent,38,0,38,0.02
Kangayam,22,RAJENDRAN.B,Independent,94,1,95,0.05
Kangayam,23,RAJENDRAN.P,Independent,40,0,40,0.02
Kangayam,24,VADUGANATHAN.K.K.,Independent,83,0,83,0.04
Kangayam,25,JAHANGEER.K.O.,Independent,88,1,89,0.04
Kangayam,26,JOTHI KALIMUTHU.G,Independent,84,0,84,0.04
Kangayam,27,NOTA,None of the Above,1020,7,1027,0.51
Kanniyakumari,1,AUSTIN S.,Dravida Munnetra Kazhagam,91511,2021,93532,41.59
Kanniyakumari,2,SUTHARMAN C.J.,Bahujan Samaj Party,675,6,681,0.3
Kanniyakumari,3,THALAVAI SUNDARAM N.,All India Anna Dravida Munnetra Kazhagam,108136,1609,109745,48.8
Kanniyakumari,4,SASIKALA  R.,Naam Tamilar Katchi,14072,68,14140,6.29
Kanniyakumari,5,SENTHIL MURUGAN  P.,Amma Makkal Munnettra Kazagam,1570,19,1589,0.71
Kanniyakumari,6,SELVAKUMAR  P.T.,Makkal Needhi Maiam,3100,6,3106,1.38
Kanniyakumari,7,AUGUSTIN A.,Independent,445,1,446,0.2
Kanniyakumari,8,SUNDARA NATHAN Y.,Independent,50,0,50,0.02
Kanniyakumari,9,SUBASH S.,Independent,77,1,78,0.03
Kanniyakumari,10,CHELLIAH PILLAI I.,Independent,55,0,55,0.02
Kanniyakumari,11,THANU NEELAN S.,Independent,95,0,95,0.04
Kanniyakumari,12,MAKESH N.,Independent,115,4,119,0.05
Kanniyakumari,13,MANICKAVASAGAM PILLAI NA.,Independent,141,1,142,0.06
Kanniyakumari,14,NOTA,None of the Above,1092,4,1096,0.49
Karaikudi,1,N.Baluswamy,Bahujan Samaj Party,649,3,652,0.31
Karaikudi,2,S.Mangudi,Indian National Congress,73777,2177,75954,35.75
Karaikudi,3,H.Raja,Bharatiya Janata Party,53863,502,54365,25.59
Karaikudi,4,N.Durai Manickam,Naam Tamilar Katchi,23725,147,23872,11.24
Karaikudi,5,Dherpoki V Pandi,Amma Makkal Munnettra Kazagam,44561,303,44864,21.12
Karaikudi,6,Rajkumar.G,Anna MGR Dravida Makkal Kalgam,338,3,341,0.16
Karaikudi,7,S.Rajkumar,Makkal Needhi Maiam,8260,91,8351,3.93
Karaikudi,8,B.Vanitha,Puthiya Tamilagam,698,4,702,0.33
Karaikudi,9,A.Ganesan,Independent,340,6,346,0.16
Karaikudi,10,M.Naina Mohamed,Independent,412,4,416,0.2
Karaikudi,11,A.Paramasivam,Independent,192,0,192,0.09
Karaikudi,12,N.Meenal,Independent,543,5,548,0.26
Karaikudi,13,K.Velu,Independent,498,6,504,0.24
Karaikudi,14,NOTA,None of the Above,1329,20,1349,0.63
Karur,1,AADHIKRISHNAN.P,Bahujan Samaj Party,210,0,210,0.1
Karur,2,SENTHILBALAJI V,Dravida Munnetra Kazhagam,100356,1401,101757,49.08
Karur,3,THANGARAJ.N,Desiya Murpokku Dravida Kazhagam,946,7,953,0.46
Karur,4,VIJAYABHASKAR. M.R,All India Anna Dravida Munnetra Kazhagam,88440,869,89309,43.08
Karur,5,KARUPPAIYA.R,Naam Tamilar Katchi,7286,30,7316,3.53
Karur,6,SHANMUGAM.N,Samaniya Makkal Nala Katchi,99,0,99,0.05
Karur,7,DHANALAKSHMI.M,Ganasangam Party of India,105,0,105,0.05
Karur,8,MOHANRAJ.S,Makkal Needhi Maiam,4138,16,4154,2
Karur,9,JOSEPH.M.A,Desiya Makkal Sakthi Katchi,39,0,39,0.02
Karur,10,ABILAZAN.N,Independent,29,0,29,0.01
Karur,11,AMARNATH.K,Independent,28,0,28,0.01
Karur,12,AMARSRI.M,Independent,56,0,56,0.03
Karur,13,ANBAZHAGAN,Independent,334,0,334,0.16
Karur,14,RAVI.P,Independent,366,3,369,0.18
Karur,15,KANNAN.T,Independent,165,0,165,0.08
Karur,16,KATHIRAVAN.P,Independent,114,0,114,0.05
Karur,17,KARUNAMOORTHY.S,Independent,29,0,29,0.01
Karur,18,KALAI RAJ.K,Independent,51,0,51,0.02
Karur,19,KAMARAJ.P,Independent,15,0,15,0.01
Karur,20,KRISHNAKUMAR.S,Independent,42,0,42,0.02
Karur,21,GOPALAKRISHNAN.A,Independent,19,0,19,0.01
Karur,22,SAKTHIKUMAR,Independent,2,0,2,0
Karur,23,SANTHANAKUMAR.M,Independent,3,1,4,0
Karur,24,SATHISH.P,Independent,10,0,10,0
Karur,25,SAMPATH.S,Independent,9,0,9,0
Karur,26,SARAVANAN.R,Independent,10,0,10,0
Karur,27,SAMIAPPAN.K,Independent,10,0,10,0
Karur,28,SAMIVEL.A,Independent,12,0,12,0.01
Karur,29,SHIVAKUMAR.K,Independent,29,0,29,0.01
Karur,30,SIVAKUMAR.N,Independent,18,0,18,0.01
Karur,31,SIVAKUMAR.V,Independent,46,0,46,0.02
Karur,32,SIVASAMY.P,Independent,37,0,37,0.02
Karur,33,SUDHAKAR.S,Independent,7,0,7,0
Karur,34,SUDHAKAR.L,Independent,19,0,19,0.01
Karur,35,SUBASH MALAYALAM.T,Independent,8,0,8,0
Karur,36,SURYA,Independent,96,0,96,0.05
Karur,37,SENTHILKUMAR.A,Independent,13,0,13,0.01
Karur,38,SENTHILKUMAR.A.M,Independent,2,0,2,0
Karur,39,SELVAKUMAR.M,Independent,7,0,7,0
Karur,40,DANIYA,Independent,11,0,11,0.01
Karur,41,TAMILARASAN.K,Independent,13,0,13,0.01
Karur,42,THAMILALAGAN,Independent,7,0,7,0
Karur,43,DHANABAL,Independent,7,0,7,0
Karur,44,THIRUGNANAM.M,Independent,13,0,13,0.01
Karur,45,DEEPANANDH.N,Independent,14,0,14,0.01
Karur,46,DURAISAMY.J,Independent,5,0,5,0
Karur,47,NOOR MOHAMMED THOUFFIC.A,Independent,13,0,13,0.01
Karur,48,PALANIVEL.P,Independent,17,0,17,0.01
Karur,49,BALAMANIKANDAN.K,Independent,56,0,56,0.03
Karur,50,BANUMATHY,Independent,16,0,16,0.01
Karur,51,PRAKASH.A,Independent,11,0,11,0.01
Karur,52,PRAKASH.N,Independent,20,0,20,0.01
Karur,53,PRAKASH.V,Independent,5,0,5,0
Karur,54,PRASANTH.S,Independent,4,0,4,0
Karur,55,PUSHPARAJ.P,Independent,3,0,3,0
Karur,56,BOOPATHI.P,Independent,6,0,6,0
Karur,57,MAHENDRAN,Independent,11,0,11,0.01
Karur,58,MANIKANDAN.K,Independent,2,0,2,0
Karur,59,MANIVANNAN.S,Independent,3,0,3,0
Karur,60,MANOJ.P,Independent,10,0,10,0
Karur,61,MUTHU. K.R,Independent,14,0,14,0.01
Karur,62,MUTHUKUMAR.G,Independent,8,0,8,0
Karur,63,MURALI.M,Independent,10,0,10,0
Karur,64,MURUGANANTHAM.T,Independent,30,0,30,0.01
Karur,65,MURUGESAN.A,Independent,83,1,84,0.04
Karur,66,MOHAN.M.L.M,Independent,42,0,42,0.02
Karur,67,MOUNAGURUBALUSAMY.K,Independent,14,0,14,0.01
Karur,68,RAJESHKANNAN.S,Independent,138,0,138,0.07
Karur,69,VIGNESHWARAN.P,Independent,25,0,25,0.01
Karur,70,VINOTHKUMAR,Independent,9,0,9,0
Karur,71,VIJAYABHASKAR.R.V,Independent,14,0,14,0.01
Karur,72,VIJAYAN.K,Independent,13,0,13,0.01
Karur,73,VEERAKUMAR.T,Independent,5,0,5,0
Karur,74,VENKADESH.K,Independent,14,0,14,0.01
Karur,75,VENKATESH PRABU.K,Independent,26,0,26,0.01
Karur,76,JAYAKUMAR.G,Independent,100,2,102,0.05
Karur,77,JOTHI SUTHARSAN,Independent,22,0,22,0.01
Karur,78,NOTA,None of the Above,954,7,961,0.46
Katpadi,1,DURAIMURUGAN,Dravida Munnetra Kazhagam,83243,1897,85140,45.71
Katpadi,2,V RAMU,All India Anna Dravida Munnetra Kazhagam,83675,719,84394,45.31
Katpadi,3,K RAJA,Bahujan Samaj Party,368,6,374,0.2
Katpadi,4,ARUMUGAM K P,Republican Party of India (Athawale),142,2,144,0.08
Katpadi,5,M SUDHARSAN,Indiya Jananayaka Katchi,991,12,1003,0.54
Katpadi,6,S THIRUKKUMARAN,Naam Tamilar Katchi,10325,124,10449,5.61
Katpadi,7,A S RAJA,Amma Makkal Munnettra Kazagam,1059,7,1066,0.57
Katpadi,8,R S SRIDHAR,Anna MGR Dravida Makkal Kalgam,75,3,78,0.04
Katpadi,9,J ANANDHI,Independent,177,16,193,0.1
Katpadi,10,P DHANANJAYAN,Independent,163,3,166,0.09
Katpadi,11,R BASKARAN,Independent,221,3,224,0.12
Katpadi,12,RAMAN,Independent,144,0,144,0.08
Katpadi,13,K RAMU,Independent,99,0,99,0.05
Katpadi,14,D RAMU,Independent,332,0,332,0.18
Katpadi,15,V VINAYAGAM,Independent,548,3,551,0.3
Katpadi,16,NOTA,None of the Above,1852,37,1889,1.01
Kattumannarkoil,1,THANGA UDHAYAKUMAR,Bahujan Samaj Party,425,4,429,0.24
Kattumannarkoil,2,N. MURUGUMARAN,All India Anna Dravida Munnetra Kazhagam,74608,883,75491,43
Kattumannarkoil,3,M.G. KALYANASUNDARAM,All India Jananayaka Makkal Kazhagam,458,2,460,0.26
Kattumannarkoil,4,SINTHANAI SELVAN,Viduthalai Chiruthaigal Katchi,84986,1070,86056,49.02
Kattumannarkoil,5,THANGA VIKRAM,Makkal Needhi Maiam,1391,24,1415,0.81
Kattumannarkoil,6,M. THIRUNAVUKARASU,Anna Puratchi Thalaivar Amma Dravida Munnetra Kazhagam,133,1,134,0.08
Kattumannarkoil,7,S. NARAYANAMOORTHY,Amma Makkal Munnettra Kazagam,1892,12,1904,1.08
Kattumannarkoil,8,P. NIVEDHA,Naam Tamilar Katchi,6762,44,6806,3.88
Kattumannarkoil,9,M.A.T. ARCHUNAN,Independent,417,4,421,0.24
Kattumannarkoil,10,A. ANANDAN,Independent,991,0,991,0.56
Kattumannarkoil,11,P.M. KUMAR,Independent,362,1,363,0.21
Kattumannarkoil,12,S.TAMILSELVAN,Independent,216,0,216,0.12
Kattumannarkoil,13,MATHIAZHAGAN,Independent,227,0,227,0.13
Kattumannarkoil,14,NOTA,None of the Above,647,1,648,0.37
Kavundampalayam,1,G.Arunkumar,All India Anna Dravida Munnetra Kazhagam,134981,688,135669,43.78
Kavundampalayam,2,R.Krishnan,Dravida Munnetra Kazhagam,124557,1336,125893,40.62
Kavundampalayam,3,Aruna.M,Amma Makkal Munnettra Kazagam,1992,10,2002,0.65
Kavundampalayam,4,Kalamani.M,Naam Tamilar Katchi,17823,74,17897,5.77
Kavundampalayam,5,Siva.K,Tamil Nadu Ilangyar Katchi,718,8,726,0.23
Kavundampalayam,6,Selvaraj.M,New Generation People’s Party,177,1,178,0.06
Kavundampalayam,7,Pankaj Jain,Makkal Needhi Maiam,23427,100,23527,7.59
Kavundampalayam,8,Arunkumar.T,Independent,294,2,296,0.1
Kavundampalayam,9,Krishnan.M,Independent,140,0,140,0.05
Kavundampalayam,10,Suriyakumar.K,Independent,117,0,117,0.04
Kavundampalayam,11,Gnanaraj.M,Independent,160,1,161,0.05
Kavundampalayam,12,Pushpanantham.V,Independent,419,1,420,0.14
Kavundampalayam,13,NOTA,None of the Above,2868,24,2892,0.93
Killiyoor,1,SIVAKUMAR  V,Bahujan Samaj Party,1571,25,1596,0.94
Killiyoor,2,RAJESH KUMAR  S,Indian National Congress,99393,2148,101541,59.76
Killiyoor,3,JUDE DEV   K.V,All India Anna Dravida Munnetra Kazhagam,45419,722,46141,27.15
Killiyoor,4,ANTONY  A,All India Samathuva Makhal Katchi,1205,9,1214,0.71
Killiyoor,5,SEEMA  A,Amma Makkal Munnettra Kazagam,1079,23,1102,0.65
Killiyoor,6,THANKAPPAN C,Tamilnadu Mahatma Gandhi Makkal Katchi,159,3,162,0.1
Killiyoor,7,PETER H,Naam Tamilar Katchi,14328,189,14517,8.54
Killiyoor,8,VIJIKUMAR K,National Democratic Party of South India,184,2,186,0.11
Killiyoor,9,JAYARAJ E,Tamil Nadu Ilangyar Katchi,1429,14,1443,0.85
Killiyoor,10,ANCHALOSE R,Independent,210,3,213,0.13
Killiyoor,11,SIVAN RAJ  K,Independent,315,8,323,0.19
Killiyoor,12,RAMESH RAJA KUMAR C,Independent,275,3,278,0.16
Killiyoor,13,JOHN BENADICT G,Independent,233,2,235,0.14
Killiyoor,14,SHAJU SINGH M R,Independent,211,2,213,0.13
Killiyoor,15,NOTA,None of the Above,747,7,754,0.44
Kilpennathur,1,SubashChandrabose,Bahujan Samaj Party,593,5,598,0.29
Kilpennathur,2,K.Pitchandi,Dravida Munnetra Kazhagam,102713,1962,104675,51.34
Kilpennathur,3,A.R.Elumalai,Veerath Thiyagi Viswanathadoss Thozhilalarkal Katchi,497,7,504,0.25
Kilpennathur,4,P.Kathikeyan,Amma Makkal Munnettra Kazagam,2172,19,2191,1.07
Kilpennathur,5,V.Suganantham,Makkal Needhi Maiam,1431,6,1437,0.7
Kilpennathur,6,K.Selvakumar,Pattali Makkal Katchi,76854,1034,77888,38.2
Kilpennathur,7,N.Thangaraj,Makkal Munnetra Peravai,313,4,317,0.16
Kilpennathur,8,Dr.R.Rameshbabu,Naam Tamilar Katchi,11464,77,11541,5.66
Kilpennathur,9,A.Venkatesan,Republican Party of India (Athawale),147,0,147,0.07
Kilpennathur,10,Farmer Jayaraman,Anaithu Makkal Arasiyal Katchi,236,3,239,0.12
Kilpennathur,11,M.Athiyaman,Independent,185,0,185,0.09
Kilpennathur,12,P.Ganeshraja,Independent,194,3,197,0.1
Kilpennathur,13,G.krishnamurthy,Independent,86,39,125,0.06
Kilpennathur,14,Sakthivel,Independent,407,1,408,0.2
Kilpennathur,15,S.Sasikumar,Independent,592,5,597,0.29
Kilpennathur,16,M.Sampathraj,Independent,415,2,417,0.2
Kilpennathur,17,M.Dinakaran,Independent,251,20,271,0.13
Kilpennathur,18,M.Murugan,Independent,835,9,844,0.41
Kilpennathur,19,M.Mohanraja,Independent,117,0,117,0.06
Kilpennathur,20,Lourdammal,Independent,75,0,75,0.04
Kilpennathur,21,C.Jothi,Independent,151,1,152,0.07
Kilpennathur,22,NOTA,None of the Above,954,7,961,0.47
Kilvaithinankuppam,1,K Seetharaman,Dravida Munnetra Kazhagam,72933,1064,73997,42.5
Kilvaithinankuppam,2,DHANASEELAN,Desiya Murpokku Dravida Kazhagam,1406,26,1432,0.82
Kilvaithinankuppam,3,PUSHPALATHA D,Bahujan Samaj Party,505,14,519,0.3
Kilvaithinankuppam,4,M.JAGAN MOORTHY,All India Anna Dravida Munnetra Kazhagam,83989,590,84579,48.57
Kilvaithinankuppam,5,K ELAVARASAN,Republican Party of India (Athawale),543,4,547,0.31
Kilvaithinankuppam,6,K SATHU,National Democratic Party of South India,132,1,133,0.08
Kilvaithinankuppam,7,J.Divya Rani,Naam Tamilar Katchi,9911,116,10027,5.76
Kilvaithinankuppam,8,K VENKATASAMY,Indiya Jananayaka Katchi,519,0,519,0.3
Kilvaithinankuppam,9,E.P.ELANCHEZHIYAN,Independent,238,4,242,0.14
Kilvaithinankuppam,10,S SELVA CHENGUTTUVAN,Independent,324,7,331,0.19
Kilvaithinankuppam,11,NOTA,None of the Above,1773,25,1798,1.03
Kilvelur,1,TAMILARASAN U,Bahujan Samaj Party,636,5,641,0.45
Kilvelur,2,NAGAIMAALI V P,Communist Party of India  (Marxist),67288,700,67988,47.55
Kilvelur,3,SIDHU G,Makkal Needhi Maiam,2890,16,2906,2.03
Kilvelur,4,NEETHIMOHAN M,Amma Makkal Munnettra Kazagam,2494,9,2503,1.75
Kilvelur,5,PONELAVAZHAKI  S,Naam Tamilar Katchi,15088,85,15173,10.61
Kilvelur,6,MUTHALAGAN S,Puthiya Tamilagam,614,0,614,0.43
Kilvelur,7,VADIVEL RAVANAN  S,Pattali Makkal Katchi,50754,249,51003,35.67
Kilvelur,8,KALAISELVAN G,Independent,613,2,615,0.43
Kilvelur,9,MARUTHAIYAN G,Independent,171,2,173,0.12
Kilvelur,10,VEDHA MUKUNDHAN,Independent,481,1,482,0.34
Kilvelur,11,NOTA,None of the Above,895,2,897,0.63
Kinathukadavu,1,Kuruchi Prabhakaran,Dravida Munnetra Kazhagam,99311,1131,100442,43.21
Kinathukadavu,2,Damodaran.S,All India Anna Dravida Munnetra Kazhagam,101069,468,101537,43.68
Kinathukadavu,3,Anbazhagan.G,Veerath Thiyagi Viswanathadoss Thozhilalarkal Katchi,352,1,353,0.15
Kinathukadavu,4,Umajagadesh.M,Naam Tamilar Katchi,11249,31,11280,4.85
Kinathukadavu,5,Siva.A,Makkal Needhi Maiam,13880,59,13939,6
Kinathukadavu,6,Mariappan.R,Ganasangam Party of India,187,0,187,0.08
Kinathukadavu,7,ROHINI MA.PA,Amma Makkal Munnettra Kazagam,1237,11,1248,0.54
Kinathukadavu,8,James.S,All India Jananayaka Makkal Kazhagam,55,0,55,0.02
Kinathukadavu,9,Atheeswaran.S,Independent,50,0,50,0.02
Kinathukadavu,10,Dharmalingam.K,Independent,107,1,108,0.05
Kinathukadavu,11,Nazir Babu.S,Independent,88,0,88,0.04
Kinathukadavu,12,Nagendran.P,Independent,225,3,228,0.1
Kinathukadavu,13,Noor Muhamad . A,Independent,135,0,135,0.06
Kinathukadavu,14,Velusamy.V,Independent,504,1,505,0.22
Kinathukadavu,15,NOTA,None of the Above,2268,12,2280,0.98
Kolathur,1,AADIRAJARAM,All India Anna Dravida Munnetra Kazhagam,34801,337,35138,20.27
Kolathur,2,MJS.JAMAL MOHAMED MEERA,Bahujan Samaj Party,1286,9,1295,0.75
Kolathur,3,M.K. STALIN,Dravida Munnetra Kazhagam,104305,1217,105522,60.86
Kolathur,4,ASHOK KUMAR.S,New Generation People’s Party,257,0,257,0.15
Kolathur,5,J.ARUMUGAM,Amma Makkal Munnettra Kazagam,1075,5,1080,0.62
Kolathur,6,ELUMALAI.K,Veerath Thiyagi Viswanathadoss Thozhilalarkal Katchi,69,0,69,0.04
Kolathur,7,F.CAMILUS SELVA,Naam Tamilar Katchi,11234,45,11279,6.51
Kolathur,8,A.SEETHA,Bahujan Dravida Party,41,0,41,0.02
Kolathur,9,SURESH,Tamil Nadu Ilangyar Katchi,619,1,620,0.36
Kolathur,10,S.SURESHKUMAR,Makkalatchi Katchi,38,5,43,0.02
Kolathur,11,D.SURESHBABU,Desiya Makkal Sakthi Katchi,87,0,87,0.05
Kolathur,12,E.RAJENDRAN,Anna MGR Dravida Makkal Kalgam,25,5,30,0.02
Kolathur,13,M.RAJENDRAN,National Democratic Party of South India,65,0,65,0.04
Kolathur,14,VIVEKRAJ.J,Thamizhaga Munnetra Congress,116,0,116,0.07
Kolathur,15,G.VELMURUGAN,Shiv Sena,130,2,132,0.08
Kolathur,16,A.JAGADISH KUMAR,Makkal Needhi Maiam,13989,87,14076,8.12
Kolathur,17,AGNI SRI RAMACHANDRAN,Independent,680,1,681,0.39
Kolathur,18,L.KATHIRESAN,Independent,118,0,118,0.07
Kolathur,19,SATHIYASEELAN,Independent,86,0,86,0.05
Kolathur,20,V.SURESHKUMAR,Independent,22,0,22,0.01
Kolathur,21,J.SURIYAMUTHU,Independent,109,1,110,0.06
Kolathur,22,M.A.S. SENTHIL KUMAR,Independent,32,1,33,0.02
Kolathur,23,P.SENTHIL KUMAR,Independent,38,0,38,0.02
Kolathur,24,R.SELVAM,Independent,32,1,33,0.02
Kolathur,25,DIVYA,Independent,180,1,181,0.1
Kolathur,26,DEVIKARANI,Independent,37,0,37,0.02
Kolathur,27,AL. NARESH KUMAR,Independent,198,0,198,0.11
Kolathur,28,NIRMALA DEVI,Independent,29,0,29,0.02
Kolathur,29,D.NILAMANI,Independent,44,1,45,0.03
Kolathur,30,K. PANNERSELVAM,Independent,38,2,40,0.02
Kolathur,31,MALARVIZHI,Independent,92,0,92,0.05
Kolathur,32,MIRZA SAFDAR ALI,Independent,97,0,97,0.06
Kolathur,33,RAMA DEVI,Independent,61,0,61,0.04
Kolathur,34,B.VIJAYA KUMAR,Independent,18,0,18,0.01
Kolathur,35,C.JEEVAKUMAR,Independent,52,0,52,0.03
Kolathur,36,P.HARISHKUMAR,Independent,38,0,38,0.02
Kolathur,37,NOTA,None of the Above,1518,11,1529,0.88
Kovilpatti,1,KADAMBUR RAJU,All India Anna Dravida Munnetra Kazhagam,67970,586,68556,37.89
Kovilpatti,2,K.Srinivasan,Communist Party of India  (Marxist),36234,1146,37380,20.66
Kovilpatti,3,Ramachandiran.R,Bahujan Samaj Party,200,3,203,0.11
Kovilpatti,4,S.Udaiyar,Naam Indiar Party,175,0,175,0.1
Kovilpatti,5,K.Kathiravan,Makkal Needhi Maiam,3628,39,3667,2.03
Kovilpatti,6,M.Gomathi,Naam Tamilar Katchi,9114,99,9213,5.09
Kovilpatti,7,K.Shanmugasundaram,Bahujan Dravida Party,244,2,246,0.14
Kovilpatti,8,TTV DHINAKARAN,Amma Makkal Munnettra Kazagam,55729,424,56153,31.04
Kovilpatti,9,M.G.R.Nambbi,All India MGR Makkal Munnetra Kazhagam,244,0,244,0.13
Kovilpatti,10,RAJKUMAR POLIAH,Universal Brotherhood Movement,97,2,99,0.05
Kovilpatti,11,Athikaran @ Athikumar,Independent,638,6,644,0.36
Kovilpatti,12,J.Ravisankar Jayachanthiran,Independent,203,2,205,0.11
Kovilpatti,13,P.Ramasamy,Independent,66,0,66,0.04
Kovilpatti,14,Kannan,Independent,121,0,121,0.07
Kovilpatti,15,A.Kaliraj,Independent,315,0,315,0.17
Kovilpatti,16,P.Gunasekaran,Independent,405,7,412,0.23
Kovilpatti,17,Sivasubramanian,Independent,420,0,420,0.23
Kovilpatti,18,Subash,Independent,442,1,443,0.24
Kovilpatti,19,A.PattuRani,Independent,134,2,136,0.08
Kovilpatti,20,K.Pandimuneeswari,Independent,78,3,81,0.04
Kovilpatti,21,M.Ponnusamy,Independent,118,2,120,0.07
Kovilpatti,22,Manthirasudamani,Independent,103,1,104,0.06
Kovilpatti,23,M.Marimuthu,Independent,133,0,133,0.07
Kovilpatti,24,Rameshkannan,Independent,498,0,498,0.28
Kovilpatti,25,Raja,Independent,79,1,80,0.04
Kovilpatti,26,Renganayagalu,Independent,90,0,90,0.05
Kovilpatti,27,NOTA,None of the Above,1106,18,1124,0.62
Krishnagiri,1,Ashokkumar.K,All India Anna Dravida Munnetra Kazhagam,95300,750,96050,45.38
Krishnagiri,2,CHANDRAMOHAN.K.M,Nationalist Congress Party,1072,16,1088,0.51
Krishnagiri,3,SENGUTTUVAN.T,Dravida Munnetra Kazhagam,93507,1749,95256,45.01
Krishnagiri,4,TAMILSELVAN.S,Bahujan Samaj Party,485,3,488,0.23
Krishnagiri,5,AMEENULLA,All India Majlis-E-Ittehadul Muslimeen,851,7,858,0.41
Krishnagiri,6,SASIKUMAR.K.S,Anna Puratchi Thalaivar Amma Dravida Munnetra Kazhagam,128,1,129,0.06
Krishnagiri,7,NIRANDARI.V,Naam Tamilar Katchi,11009,128,11137,5.26
Krishnagiri,8,RAVISHANKAR.R.K,Makkal Needhi Maiam,3423,32,3455,1.63
Krishnagiri,9,RUTHRAMANI.T,Desiya Makkal Sakthi Katchi,84,5,89,0.04
Krishnagiri,10,VIJAYAKUMAR.R,Veerath Thiyagi Viswanathadoss Thozhilalarkal Katchi,133,4,137,0.06
Krishnagiri,11,TVS GANDHI,Independent,97,0,97,0.05
Krishnagiri,12,KUMARESAN.M,Independent,59,0,59,0.03
Krishnagiri,13,GOPINATH.M,Independent,229,3,232,0.11
Krishnagiri,14,SAKTHI.K,Independent,417,1,418,0.2
Krishnagiri,15,SIVAN.C,Independent,314,4,318,0.15
Krishnagiri,16,NOTA,None of the Above,1827,10,1837,0.87
Krishnarayapuram,1,KATHIRVEL.M,Desiya Murpokku Dravida Kazhagam,1940,6,1946,1.08
Krishnarayapuram,2,SIVAGAMA SUNDARI.K,Dravida Munnetra Kazhagam,95321,1219,96540,53.37
Krishnarayapuram,3,MUTHUKUMAR,All India Anna Dravida Munnetra Kazhagam,64507,408,64915,35.88
Krishnarayapuram,4,MURUGESAN.R,Bahujan Samaj Party,538,2,540,0.3
Krishnarayapuram,5,ASHOKAN.P,Puthiya Tamilagam,194,1,195,0.11
Krishnarayapuram,6,ILAKIYA.R,Naam Tamilar Katchi,9654,52,9706,5.37
Krishnarayapuram,7,CHANDRA.P,My India Party,128,0,128,0.07
Krishnarayapuram,8,SARAVANAN.V,Makkal Needhi Maiam,1837,11,1848,1.02
Krishnarayapuram,9,NARAYANAN.KR,Communist Party of India  (Marxist-Leninist)  (Liberation),100,1,101,0.06
Krishnarayapuram,10,RAJAGURU. M,Samaniya Makkal Nala Katchi,121,1,122,0.07
Krishnarayapuram,11,KRISHNAMOORTHI.M,Independent,119,0,119,0.07
Krishnarayapuram,12,GOPI KRISHNAN.P,Independent,97,0,97,0.05
Krishnarayapuram,13,SAKTHIVEL.K,Independent,151,0,151,0.08
Krishnarayapuram,14,SATHYARAJ,Independent,433,0,433,0.24
Krishnarayapuram,15,SIVAKUMAR. O,Independent,910,1,911,0.5
Krishnarayapuram,16,CHINNASAMY.V,Independent,377,0,377,0.21
Krishnarayapuram,17,SENTHILKUMAR.M,Independent,214,0,214,0.12
Krishnarayapuram,18,SELVAKUMAR.S,Independent,710,0,710,0.39
Krishnarayapuram,19,TAMIL SELVAN.M,Independent,242,0,242,0.13
Krishnarayapuram,20,NAGARAJAN. C,Independent,68,0,68,0.04
Krishnarayapuram,21,MAHAMUNI.A,Independent,27,0,27,0.01
Krishnarayapuram,22,MAHESWARAN.A,Independent,24,0,24,0.01
Krishnarayapuram,23,MUHILAN.T,Independent,21,0,21,0.01
Krishnarayapuram,24,MURUGANANTHAM.T,Independent,69,0,69,0.04
Krishnarayapuram,25,RAMESH.N.P,Independent,107,1,108,0.06
Krishnarayapuram,26,RAJAGOPAL.K,Independent,113,0,113,0.06
Krishnarayapuram,27,NOTA,None of the Above,1172,5,1177,0.65
Kulithalai,1,P.Anbalagan,Bahujan Samaj Party,585,5,590,0.3
Kulithalai,2,N.R.Chandrasekar,All India Anna Dravida Munnetra Kazhagam,76579,710,77289,39.14
Kulithalai,3,R.Manickam,Dravida Munnetra Kazhagam,99285,1544,100829,51.06
Kulithalai,4,M.Sankar,Samaniya Makkal Nala Katchi,455,5,460,0.23
Kulithalai,5,A.Subethar,Tipu Sultan Party,213,2,215,0.11
Kulithalai,6,V.Nirosha,Amma Makkal Munnettra Kazagam,754,7,761,0.39
Kulithalai,7,Seeni.Prakasu,Naam Tamilar Katchi,11426,85,11511,5.83
Kulithalai,8,S.Manikandan,Indiya Jananayaka Katchi,670,4,674,0.34
Kulithalai,9,V.Alex Mouris,Independent,244,1,245,0.12
Kulithalai,10,S.Kandasamy,Independent,138,0,138,0.07
Kulithalai,11,R.Kalyana Sundaram,Independent,109,2,111,0.06
Kulithalai,12,R.Chandrasekar,Independent,674,20,694,0.35
Kulithalai,13,M.Saravanan,Independent,213,8,221,0.11
Kulithalai,14,R.Saravanan,Independent,834,4,838,0.42
Kulithalai,15,K.Suresh,Independent,490,4,494,0.25
Kulithalai,16,B.Selvaraj,Independent,399,0,399,0.2
Kulithalai,17,S.Barani,Independent,184,0,184,0.09
Kulithalai,18,V.Vellaiyan,Independent,612,0,612,0.31
Kulithalai,19,NOTA,None of the Above,1187,4,1191,0.6
Kumarapalayam,1,K.R.SIVASUBIRAMANIYAN,Desiya Murpokku Dravida Kazhagam,1021,1,1022,0.51
Kumarapalayam,2,THANGAMANI.P,All India Anna Dravida Munnetra Kazhagam,100201,599,100800,49.92
Kumarapalayam,3,M.VENKATACHALAM,Dravida Munnetra Kazhagam,68521,633,69154,34.25
Kumarapalayam,4,K.KAMARAJ,Makkal Needhi Maiam,6107,18,6125,3.03
Kumarapalayam,5,R.KUMARESAN,Manitha Urimaigal Kalaagam,304,0,304,0.15
Kumarapalayam,6,R.KUMAR,Ambedkarite Party of India,55,2,57,0.03
Kumarapalayam,7,SUBRAMANI.S,Communist Party of India  (Marxist-Leninist)  (Liberation),112,1,113,0.06
Kumarapalayam,8,S.VARUN,Naam Tamilar Katchi,13171,69,13240,6.56
Kumarapalayam,9,V.AMIRTHALINGAM,Independent,118,1,119,0.06
Kumarapalayam,10,OMMSHARRAVANA.S,Independent,7305,37,7342,3.64
Kumarapalayam,11,M.KATHAVARAYAN,Independent,76,0,76,0.04
Kumarapalayam,12,KARTHI,Independent,155,0,155,0.08
Kumarapalayam,13,GOPALAKRISHNAN,Independent,61,2,63,0.03
Kumarapalayam,14,GOWRISANKARAN,Independent,199,1,200,0.1
Kumarapalayam,15,SARAVANAN,Independent,242,0,242,0.12
Kumarapalayam,16,P.SENGODAGOUNDAR,Independent,409,2,411,0.2
Kumarapalayam,17,K.SELLAPPAN,Independent,131,0,131,0.06
Kumarapalayam,18,M.DHANASEKARAN,Independent,252,0,252,0.12
Kumarapalayam,19,B.BALAKRISHNAN,Independent,188,0,188,0.09
Kumarapalayam,20,S.PRABHAKARAN,Independent,37,0,37,0.02
Kumarapalayam,21,S.PONGIYANNAN,Independent,193,1,194,0.1
Kumarapalayam,22,MANIKANDAN,Independent,22,0,22,0.01
Kumarapalayam,23,M.YUVARAJ,Independent,30,0,30,0.01
Kumarapalayam,24,G.RAGAVENDIRAN,Independent,23,0,23,0.01
Kumarapalayam,25,G.RAJUGANESAN,Independent,42,0,42,0.02
Kumarapalayam,26,K.A.VIJAYAN,Independent,35,0,35,0.02
Kumarapalayam,27,A.VENKATACHALAM,Independent,27,0,27,0.01
Kumarapalayam,28,K.VENKATACHALAM,Independent,77,1,78,0.04
Kumarapalayam,29,P.VENKATACHALAM,Independent,100,1,101,0.05
Kumarapalayam,30,NOTA,None of the Above,1337,5,1342,0.66
Kumbakonam,1,"ANBALAGAN, G.",Dravida Munnetra Kazhagam,94284,1773,96057,48.62
Kumbakonam,2,"SRITHAR VANDAYAR, G.M.",All India Anna Dravida Munnetra Kazhagam,74334,340,74674,37.8
Kumbakonam,3,"ANANDH, M.",Naam Tamilar Katchi,12419,61,12480,6.32
Kumbakonam,4,"GOPALAKRISHNAN, G.",Makkal Needhi Maiam,5234,42,5276,2.67
Kumbakonam,5,"BALAMURUGAN, S.",Amma Makkal Munnettra Kazagam,6475,48,6523,3.3
Kumbakonam,6,"AYYAPPAN, M.",Independent,208,1,209,0.11
Kumbakonam,7,"GURUMOORTHI, D.",Independent,229,5,234,0.12
Kumbakonam,8,"SUBRAMANIAN, P.",Independent,151,2,153,0.08
Kumbakonam,9,"PRAKASH, P.",Independent,119,1,120,0.06
Kumbakonam,10,"VIJAYAKUMAR, C.",Independent,190,0,190,0.1
Kumbakonam,11,NOTA,None of the Above,1623,25,1648,0.83
Kunnam,1,"RAMACHANDRAN, R.T.",All India Anna Dravida Munnetra Kazhagam,96734,859,97593,44.38
Kunnam,2,"SIVASANKAR, S.S.",Dravida Munnetra Kazhagam,102707,1215,103922,47.26
Kunnam,3,"PANDIYAN, S.",Bahujan Samaj Party,494,0,494,0.22
Kunnam,4,"ARUL, P.",Naam Tamilar Katchi,9319,35,9354,4.25
Kunnam,5,"RAVANAN, M.",New Generation People’s Party,183,4,187,0.09
Kunnam,6,"KAARTHIKEYAN, S.",Amma Makkal Munnettra Kazagam,2092,26,2118,0.96
Kunnam,7,"SATHIK BASHA, A.S.",Makkal Needhi Maiam,731,8,739,0.34
Kunnam,8,"ARUL, G.",Independent,119,4,123,0.06
Kunnam,9,"KATHIRAVAN, C.",Independent,47,1,48,0.02
Kunnam,10,"KALAISELVI, J.",Independent,67,1,68,0.03
Kunnam,11,KALAIYARASI SARAVANAN,Independent,89,1,90,0.04
Kunnam,12,"GOWTHAMAN, V.",Independent,331,5,336,0.15
Kunnam,13,"SURESHKUMAR, S.",Independent,265,4,269,0.12
Kunnam,14,"SELVAM, J.",Independent,174,0,174,0.08
Kunnam,15,"SELVARAJU, R.",Independent,977,0,977,0.44
Kunnam,16,"BALAMURUGAN, S.",Independent,934,0,934,0.42
Kunnam,17,"PRAKASH, M.R.",Independent,604,0,604,0.27
Kunnam,18,"PUGALENTHI, Dr.S.",Independent,366,0,366,0.17
Kunnam,19,"MANIKANDAN, K.",Independent,152,0,152,0.07
Kunnam,20,"MATHIYAZHAGAN, S.",Independent,86,1,87,0.04
Kunnam,21,"MUTHAMILSELVAN, D.",Independent,40,0,40,0.02
Kunnam,22,"VINOTHKUMAR, M.",Independent,451,0,451,0.21
Kunnam,23,NOTA,None of the Above,751,2,753,0.34
Kurinjipadi,1,SELVI RAMAJAYAM,All India Anna Dravida Munnetra Kazhagam,83478,451,83929,42.22
Kurinjipadi,2,M.R.K.PANNEERSELVAM,Dravida Munnetra Kazhagam,100463,993,101456,51.04
Kurinjipadi,3,T.VELAYUDHAM,Bahujan Samaj Party,480,2,482,0.24
Kurinjipadi,4,K.CHANDRAMOULI,Janata Dal  (Secular),1178,11,1189,0.6
Kurinjipadi,5,S.SUMATHI,Naam Tamilar Katchi,8470,42,8512,4.28
Kurinjipadi,6,R.MUTHUKRISHNAN,Anna Dravidar Kazhagam,140,0,140,0.07
Kurinjipadi,7,A.VASANTHAKUMAR,Amma Makkal Munnettra Kazagam,834,3,837,0.42
Kurinjipadi,8,R.SARATHKUMAR,Independent,154,0,154,0.08
Kurinjipadi,9,BRIJITA ROSLENE,Independent,91,1,92,0.05
Kurinjipadi,10,L.MADHIYAZHAGAN,Independent,139,0,139,0.07
Kurinjipadi,11,N.MUTHAZHAGAN,Independent,124,0,124,0.06
Kurinjipadi,12,R.RAJESH,Independent,515,0,515,0.26
Kurinjipadi,13,NOTA,None of the Above,1208,4,1212,0.61
Lalgudi,1,A.SOUNDARAPANDIAN,Dravida Munnetra Kazhagam,83264,1650,84914,48.59
Lalgudi,2,D.R.DHARMARAJ,All India Anna Dravida Munnetra Kazhagam,67612,353,67965,38.89
Lalgudi,3,K.KAMARAJ,Samaniya Makkal Nala Katchi,268,2,270,0.15
Lalgudi,4,R.SILAMBARASAN,Anna MGR Dravida Makkal Kalgam,138,0,138,0.08
Lalgudi,5,P.NAMBIRAJAN,Puthiya Tamilagam,123,1,124,0.07
Lalgudi,6,I.MALAR TAMIL PRABHA,Naam Tamilar Katchi,16134,114,16248,9.3
Lalgudi,7,VEERAN.MUTHUKUMAR,Shiv Sena,64,1,65,0.04
Lalgudi,8,M.VIJAYAMURTHY,Amma Makkal Munnettra Kazagam,2913,28,2941,1.68
Lalgudi,9,K.ANANTHABABU,Independent,56,1,57,0.03
Lalgudi,10,A.ANANDHKUMAR,Independent,92,4,96,0.05
Lalgudi,11,P.M.SAHADEVAN,Independent,65,0,65,0.04
Lalgudi,12,ANBIL K.THANGAMANI,Independent,246,1,247,0.14
Lalgudi,13,K.DHARMARAJ,Independent,120,0,120,0.07
Lalgudi,14,U.JOHNSON,Independent,303,1,304,0.17
Lalgudi,15,NOTA,None of the Above,1191,9,1200,0.69
Madathukulam,1,J.BENJAMIN KIRUBAKARAN,Bahujan Samaj Party,465,2,467,0.26
Madathukulam,2,C MAHENDRAN,All India Anna Dravida Munnetra Kazhagam,83634,679,84313,46.35
Madathukulam,3,R.JAYARAMAKRISHNAN,Dravida Munnetra Kazhagam,76885,990,77875,42.81
Madathukulam,4,K KUMARESAN,Makkal Needhi Maiam,2877,17,2894,1.59
Madathukulam,5,K SAKTHIVEL,Anna Puratchi Thalaivar Amma Dravida Munnetra Kazhagam,105,0,105,0.06
Madathukulam,6,C.SHANMUGAVELU,Amma Makkal Munnettra Kazagam,6467,48,6515,3.58
Madathukulam,7,U SANUJA,Naam Tamilar Katchi,6200,45,6245,3.43
Madathukulam,8,M SHANMUGAVEL,Independent,130,0,130,0.07
Madathukulam,9,P SUBRAMANIAN,Independent,83,0,83,0.05
Madathukulam,10,P THANGARAJ,Independent,86,2,88,0.05
Madathukulam,11,K.MAHALINGAM,Independent,136,5,141,0.08
Madathukulam,12,K MAHENDRAKUMAR,Independent,609,2,611,0.34
Madathukulam,13,P MAHENDRAN,Independent,171,1,172,0.09
Madathukulam,14,K MANICKASAMY,Independent,503,0,503,0.28
Madathukulam,15,G RAMAKRISHNAN,Independent,711,1,712,0.39
Madathukulam,16,NOTA,None of the Above,1042,6,1048,0.58
Madavaram,1,SUDHARSANAM. S,Dravida Munnetra Kazhagam,150654,831,151485,50.04
Madavaram,2,DEEPAK. S,Bahujan Samaj Party,1390,3,1393,0.46
Madavaram,3,Moorthy. V,All India Anna Dravida Munnetra Kazhagam,94206,208,94414,31.19
Madavaram,4,ARAVIND KUMAR. P,Desiya Makkal Sakthi Katchi,465,0,465,0.15
Madavaram,5,ELUMALAI. R,Naam Tamilar Katchi,27411,42,27453,9.07
Madavaram,6,SAMBATH. E,Shiv Sena,175,0,175,0.06
Madavaram,7,DHAKSHNAMOORTHY. D,Amma Makkal Munnettra Kazagam,7088,16,7104,2.35
Madavaram,8,YUVARAJ. M,Anna MGR Dravida Makkal Kalgam,81,0,81,0.03
Madavaram,9,VINOTH KUMAR. M,Naadaalum Makkal Katchi,113,1,114,0.04
Madavaram,10,RAMESH,Makkal Needhi Maiam,15838,39,15877,5.25
Madavaram,11,ARIVUNITHI. S,Independent,108,0,108,0.04
Madavaram,12,SAKTHIVEL. A,Independent,83,2,85,0.03
Madavaram,13,SATHISH KUMAR. S,Independent,62,0,62,0.02
Madavaram,14,SUDHARSANAN. D,Independent,169,1,170,0.06
Madavaram,15,NIRMAL KUMAR. M,Independent,101,0,101,0.03
Madavaram,16,BABU. M.G,Independent,411,2,413,0.14
Madavaram,17,MOORTHY. S,Independent,437,0,437,0.14
Madavaram,18,RAMESH. G,Independent,47,0,47,0.02
Madavaram,19,RAMU. S,Independent,431,0,431,0.14
Madavaram,20,JAYASEELAN. S,Independent,119,0,119,0.04
Madavaram,21,NOTA,None of the Above,2161,5,2166,0.72
Madurai Central,1,THAVAMANI A,Bahujan Samaj Party,283,3,286,0.19
Madurai Central,2,PALANIVEL THIAGA RAJAN,Dravida Munnetra Kazhagam,72231,974,73205,48.99
Madurai Central,3,JOTHI MUTHURAMALINGAM N,All India Anna Dravida Munnetra Kazhagam,38834,195,39029,26.12
Madurai Central,4,ESWARI M,My India Party,285,2,287,0.19
Madurai Central,5,SIKKANDAR BATCHA G S,SOCIAL DEMOCRATIC PARTY OF INDIA,3327,20,3347,2.24
Madurai Central,6,PANDIAMMAL J,Naam Tamilar Katchi,11156,59,11215,7.51
Madurai Central,7,MANI B,Makkal Needhi Maiam,14437,58,14495,9.7
Madurai Central,8,RAJAKUMAR NAIDU E V S,Tamil Telugu National Party,175,1,176,0.12
Madurai Central,9,ELANGOVAN R,Independent,264,0,264,0.18
Madurai Central,10,KREMMER SURESH,Independent,4880,27,4907,3.28
Madurai Central,11,KRISHNAPRABBU M R,Independent,437,3,440,0.29
Madurai Central,12,SATHIYENDRAN N,Independent,51,0,51,0.03
Madurai Central,13,SIVASANKAR S,Independent,94,0,94,0.06
Madurai Central,14,RAJASURIYAA K R,Independent,192,1,193,0.13
Madurai Central,15,NOTA,None of the Above,1432,9,1441,0.96
Madurai East,1,GOPALAKRISHNAN R,All India Anna Dravida Munnetra Kazhagam,72588,537,73125,30.74
Madurai East,2,MOORTHY P,Dravida Munnetra Kazhagam,120459,2270,122729,51.59
Madurai East,3,SARAVANAN T,Amma Makkal Munnettra Kazagam,6636,93,6729,2.83
Madurai East,4,BALAMURUGAN A,Puthiya Tamilagam,1737,18,1755,0.74
Madurai East,5,PRABAHARAN M,Bahujan Dravida Party,109,3,112,0.05
Madurai East,6,MUTHUKRISHNAN I,Makkal Needhi Maiam,11864,129,11993,5.04
Madurai East,7,MUTHU KRISHNAN M,Anaithu Makkal Puratchi Katchi,151,1,152,0.06
Madurai East,8,MUSTAK MOHAMED.A.K,Tipu Sultan Party,306,2,308,0.13
Madurai East,9,RAJA P,My India Party,120,2,122,0.05
Madurai East,10,LATHA J,Naam Tamilar Katchi,17504,164,17668,7.43
Madurai East,11,GANDHI K,Independent,232,1,233,0.1
Madurai East,12,CHANDRASEKARAN V,Independent,345,1,346,0.15
Madurai East,13,DINESH G,Independent,95,0,95,0.04
Madurai East,14,PALANIAMMAL P,Independent,345,4,349,0.15
Madurai East,15,JEYAKUMAR P,Independent,231,1,232,0.1
Madurai East,16,NOTA,None of the Above,1923,21,1944,0.82
Madurai North,1,SARAVANAN P,Bharatiya Janata Party,49700,394,50094,32
Madurai North,2,THALAPATHI G,Dravida Munnetra Kazhagam,71949,1061,73010,46.64
Madurai North,3,ALAGAR M,Makkal Needhi Maiam,12019,83,12102,7.73
Madurai North,4,ANBARASI S,Naam Tamilar Katchi,15178,133,15311,9.78
Madurai North,5,VASANTHAKUMAR S,Anna Dravidar Kazhagam,167,0,167,0.11
Madurai North,6,VOLTAIRE M J,SOCIALIST UNITY CENTRE OF INDIA (COMMUNIST),114,1,115,0.07
Madurai North,7,JEYAPAL M,Amma Makkal Munnettra Kazagam,3235,45,3280,2.1
Madurai North,8,ABUBAKKAR SITHICK J,Independent,138,1,139,0.09
Madurai North,9,RAAM VISHWAKARMA T,Independent,93,1,94,0.06
Madurai North,10,ISMAIL D,Independent,105,0,105,0.07
Madurai North,11,KUPPUSAMY N,Independent,49,0,49,0.03
Madurai North,12,KESAVARAJAH J,Independent,69,1,70,0.04
Madurai North,13,SANKARAPANDI P,Independent,161,2,163,0.1
Madurai North,14,THEIVAMMAL K,Independent,124,1,125,0.08
Madurai North,15,NATARAJAN R,Independent,167,1,168,0.11
Madurai North,16,NOTA,None of the Above,1548,16,1564,1
Madurai South,1,SARAVANAN. S.S,All India Anna Dravida Munnetra Kazhagam,56005,292,56297,38.08
Madurai South,2,BOOMINATHAN.M,Dravida Munnetra Kazhagam,62284,528,62812,42.49
Madurai South,3,ABBAS.M,Naam Tamilar Katchi,10430,53,10483,7.09
Madurai South,4,ESWARAN.G,Makkal Needhi Maiam,12773,48,12821,8.67
Madurai South,5,SADAM HUSSAIN.K,My India Party,104,0,104,0.07
Madurai South,6,BHARATHI KANNAMMA. S,New Generation People’s Party,140,0,140,0.09
Madurai South,7,RAAJALINGAM.SHA,Amma Makkal Munnettra Kazagam,2662,10,2672,1.81
Madurai South,8,UMESH.K.R,Independent,81,0,81,0.05
Madurai South,9,SARAVANAN.R,Independent,254,3,257,0.17
Madurai South,10,RAVICHANDRAN.V.C,Independent,116,0,116,0.08
Madurai South,11,RAJKUMAR(a)MANIKANDAN.K,Independent,162,0,162,0.11
Madurai South,12,VENGADACHALAPATHY.T.S,Independent,158,1,159,0.11
Madurai South,13,JEYA.K,Independent,175,3,178,0.12
Madurai South,14,NOTA,None of the Above,1532,19,1551,1.05
Madurai West,1,CHINNAMMAL. C,Dravida Munnetra Kazhagam,73463,1299,74762,37.07
Madurai West,2,BALACHANDRAN. P,Desiya Murpokku Dravida Kazhagam,3384,33,3417,1.69
Madurai West,3,RAJU. K,All India Anna Dravida Munnetra Kazhagam,83586,297,83883,41.59
Madurai West,4,KARTHIKEYAN. R,Akhil Bharat Hindu Mahasabha,315,3,318,0.16
Madurai West,5,SULTHAN BADUSHA. J,Anna MGR Dravida Makkal Kalgam,79,0,79,0.04
Madurai West,6,NAGAJOTHI. K,Tamil Nadu Ilangyar Katchi,2483,26,2509,1.24
Madurai West,7,MUNIYASAMY. V,Makkal Needhi Maiam,15749,100,15849,7.86
Madurai West,8,VETRIKUMARAN. C,Naam Tamilar Katchi,18133,91,18224,9.04
Madurai West,9,ARASU THIRUVALAVAN. K. K,Independent,96,1,97,0.05
Madurai West,10,ANBUMANIKANDANTAMILSOORIYAN.K,Independent,73,0,73,0.04
Madurai West,11,SULTHAN BASHA. K,Independent,43,1,44,0.02
Madurai West,12,SEBASTHIYAN. B,Independent,49,0,49,0.02
Madurai West,13,PREMKUMAR. M,Independent,122,0,122,0.06
Madurai West,14,RAMU. N,Independent,368,0,368,0.18
Madurai West,15,VENKATESAN. M,Independent,126,0,126,0.06
Madurai West,16,NOTA,None of the Above,1757,17,1774,0.88
Madurantakam,1,Sathya. C.E,Dravida Munnetra Kazhagam,81739,1337,83076,44.7
Madurantakam,2,Madhanraj. M,Bahujan Samaj Party,587,0,587,0.32
Madurantakam,3,Maragatham. K,All India Anna Dravida Munnetra Kazhagam,85791,855,86646,46.62
Madurantakam,4,Moorthi . N,Desiya Murpokku Dravida Kazhagam,2130,7,2137,1.15
Madurantakam,5,Kothandan. A,Desiya Sirupanmayinar Makkal Iyakkam,249,2,251,0.14
Madurantakam,6,Subash. S,Makkal Munnetra Peravai,120,1,121,0.07
Madurantakam,7,Sumitha. P,Naam Tamilar Katchi,9249,44,9293,5
Madurantakam,8,Dinesh. K,Makkal Needhi Maiam,1476,12,1488,0.8
Madurantakam,9,Tamizhselvan. S,Independent,633,6,639,0.34
Madurantakam,10,Ranjitham. M,Independent,233,0,233,0.13
Madurantakam,11,NOTA,None of the Above,1369,2,1371,0.74
Maduravoyal,1,GANAPATHY.K,Dravida Munnetra Kazhagam,120441,857,121298,44.29
Maduravoyal,2,SANTHAKUMAR.Y,Bahujan Samaj Party,622,6,628,0.23
Maduravoyal,3,BENJAMIN.P,All India Anna Dravida Munnetra Kazhagam,89313,264,89577,32.71
Maduravoyal,4,LAVANYA.P,Nationalist Congress Party,348,1,349,0.13
Maduravoyal,5,GANESHKUMAR.G,Naam Tamilar Katchi,20999,46,21045,7.68
Maduravoyal,6,SHANMUGAM.K,Tamil Nadu Ilangyar Katchi,906,2,908,0.33
Maduravoyal,7,SUMITHRA.R,Bahujan Dravida Party,64,0,64,0.02
Maduravoyal,8,NEVIS STELLA MARY.B,Anaithu Makkal Arasiyal Katchi,124,0,124,0.05
Maduravoyal,9,PADMA PRIYA.S,Makkal Needhi Maiam,33310,91,33401,12.2
Maduravoyal,10,MUTHURAMAN.S,Anna MGR Dravida Makkal Kalgam,69,0,69,0.03
Maduravoyal,11,LUCKY MURUGAN.E,Amma Makkal Munnettra Kazagam,2648,12,2660,0.97
Maduravoyal,12,ABARAJITHAN.R,Independent,142,1,143,0.05
Maduravoyal,13,AMALRAJ.S,Independent,69,0,69,0.03
Maduravoyal,14,ARUNKUMAR.A,Independent,95,0,95,0.03
Maduravoyal,15,GANAPATHY.R,Independent,96,0,96,0.04
Maduravoyal,16,SELVAKUMAR.V,Independent,287,0,287,0.1
Maduravoyal,17,PRIYA.K,Independent,552,1,553,0.2
Maduravoyal,18,BENJAMIN MOSES.S,Independent,149,0,149,0.05
Maduravoyal,19,MURUGAN.D,Independent,161,0,161,0.06
Maduravoyal,20,RAVI.C.V,Independent,48,0,48,0.02
Maduravoyal,21,NOTA,None of the Above,2137,9,2146,0.78
Mailam,1,SUNDARESAN A,Desiya Murpokku Dravida Kazhagam,3913,8,3921,2.22
Mailam,2,DURAI M,Bahujan Samaj Party,647,1,648,0.37
Mailam,3,Dr. MASILAMANI R,Dravida Munnetra Kazhagam,77899,915,78814,44.53
Mailam,4,UMAMAHESWARI L,Naam Tamilar Katchi,8315,25,8340,4.71
Mailam,5,SIVAKUMAR C,Pattali Makkal Katchi,80203,841,81044,45.79
Mailam,6,MANAVALAN A,Anna MGR Dravida Makkal Kalgam,373,4,377,0.21
Mailam,7,KANNAN G,Independent,109,0,109,0.06
Mailam,8,SATHIYARAJ S,Independent,144,0,144,0.08
Mailam,9,CHANDRA PRAKASH R,Independent,249,0,249,0.14
Mailam,10,SEKAR NAYAKKAR I M,Independent,137,0,137,0.08
Mailam,11,MASILAMANI V,Independent,519,5,524,0.3
Mailam,12,MASILAMANI V,Independent,805,2,807,0.46
Mailam,13,RAJASEKAR M,Independent,641,6,647,0.37
Mailam,14,SRIDHAR D,Independent,343,1,344,0.19
Mailam,15,NOTA,None of the Above,882,2,884,0.5
Manachanallur,1,V. INDIRANI,Bahujan Samaj Party,448,3,451,0.23
Manachanallur,2,S. KATHIRAVAN,Dravida Munnetra Kazhagam,114451,1883,116334,59.14
Manachanallur,3,M. PARANJOTHI,All India Anna Dravida Munnetra Kazhagam,56366,350,56716,28.83
Manachanallur,4,C. ARULMANI,Akila India Vallalar Peravai,379,0,379,0.19
Manachanallur,5,M. RAJASEKHARN,Amma Makkal Munnettra Kazagam,1619,12,1631,0.83
Manachanallur,6,Dr. KRISHNASAMY. V,Naam Tamilar Katchi,14361,82,14443,7.34
Manachanallur,7,K. GURUNATHAN,Samaniya Makkal Nala Katchi,103,0,103,0.05
Manachanallur,8,R. SAMSON,Makkal Needhi Maiam,1975,21,1996,1.01
Manachanallur,9,M. DHINAKARAN,Puthiya Tamilagam,155,3,158,0.08
Manachanallur,10,T. RENGARAJ,Tamil Nadu Ilangyar Katchi,240,0,240,0.12
Manachanallur,11,S. ROHINI,Makkal Munnetra Peravai,89,2,91,0.05
Manachanallur,12,P. JAGADEESAN,My India Party,110,2,112,0.06
Manachanallur,13,P. RAMALINGAM,Independent,107,2,109,0.06
Manachanallur,14,R. RAJASEHAR,Independent,135,2,137,0.07
Manachanallur,15,K.R.ELAIYARAJA,Independent,237,0,237,0.12
Manachanallur,16,V. GOPALAKRISHNAN,Independent,206,0,206,0.1
Manachanallur,17,R. SUDHA,Independent,158,3,161,0.08
Manachanallur,18,V.M. SELVARAJ,Independent,576,1,577,0.29
Manachanallur,19,P. NEELAMEGAM,Independent,192,0,192,0.1
Manachanallur,20,S. PUGAZHENTHI,Independent,166,2,168,0.09
Manachanallur,21,P. MACHAVALLAVAN,Independent,38,0,38,0.02
Manachanallur,22,K. MANIMARABOOPATHI,Independent,61,0,61,0.03
Manachanallur,23,A.C. MANOHARAN,Independent,43,0,43,0.02
Manachanallur,24,S. MANOJ KUMAR,Independent,55,0,55,0.03
Manachanallur,25,V. MUTHUSAMY,Independent,100,0,100,0.05
Manachanallur,26,N. MOHAN,Independent,91,0,91,0.05
Manachanallur,27,K. RAJINIKANTH,Independent,110,0,110,0.06
Manachanallur,28,P. RAJARAM,Independent,482,0,482,0.25
Manachanallur,29,V. RAJU,Independent,230,1,231,0.12
Manachanallur,30,NOTA,None of the Above,1055,12,1067,0.54
Manamadurai,1,Tamilarasi A.,Dravida Munnetra Kazhagam,87827,1537,89364,44.01
Manamadurai,2,Nagarajan S.,All India Anna Dravida Munnetra Kazhagam,74433,840,75273,37.07
Manamadurai,3,Shanmugapriya M.,Naam Tamilar Katchi,22916,312,23228,11.44
Manamadurai,4,Chandrasekar M.,Anaithu Makkal Puratchi Katchi,226,3,229,0.11
Manamadurai,5,Sivasankari P.,Makkal Needhi Maiam,2219,38,2257,1.11
Manamadurai,6,Mariappankennady S.,Amma Makkal Munnettra Kazagam,10074,157,10231,5.04
Manamadurai,7,Muralitharan M.,Anna MGR Dravida Makkal Kalgam,128,0,128,0.06
Manamadurai,8,Rajendran A.,My India Party,104,7,111,0.05
Manamadurai,9,Karuppaiah S.,Independent,83,1,84,0.04
Manamadurai,10,Thamaraiselvi S.,Independent,140,2,142,0.07
Manamadurai,11,Duraipandi M.,Independent,125,0,125,0.06
Manamadurai,12,Muthumari K.,Independent,185,0,185,0.09
Manamadurai,13,Rajaiah  C.,Independent,369,2,371,0.18
Manamadurai,14,NOTA,None of the Above,1318,15,1333,0.66
Manapparai,1,ABDUL SAMAD P,Dravida Munnetra Kazhagam,96204,1873,98077,44.23
Manapparai,2,KRISHNAGOPAL P,Desiya Murpokku Dravida Kazhagam,10666,53,10719,4.83
Manapparai,3,CHANDRASEKAR.R,All India Anna Dravida Munnetra Kazhagam,85133,701,85834,38.71
Manapparai,4,UMARANI K,Indiya Jananayaka Katchi,908,6,914,0.41
Manapparai,5,KANIMOZHI.P,Naam Tamilar Katchi,19358,92,19450,8.77
Manapparai,6,SAKTHIVEL.M,Communist Party of India  (Marxist-Leninist)  (Liberation),186,5,191,0.09
Manapparai,7,PANDIAN V,Ezhuchi Tamilargal Munnetra Kazhagam,128,1,129,0.06
Manapparai,8,VARADAN.M,Lok Jan Shakti Party,81,1,82,0.04
Manapparai,9,ARPUTHASAMY V,Independent,286,1,287,0.13
Manapparai,10,ILANGOVAN S,Independent,122,1,123,0.06
Manapparai,11,ELAYARAJA C,Independent,544,3,547,0.25
Manapparai,12,KARTHICK KRISHNA P,Independent,173,0,173,0.08
Manapparai,13,SATHYA PRIYA A,Independent,301,6,307,0.14
Manapparai,14,CHANDRASEKAR V,Independent,1255,4,1259,0.57
Manapparai,15,CHITHAIYAN T,Independent,261,9,270,0.12
Manapparai,16,CHINNAN P,Independent,649,1,650,0.29
Manapparai,17,SUBRAMANIAN P,Independent,628,0,628,0.28
Manapparai,18,DAVID P,Independent,179,1,180,0.08
Manapparai,19,NIRMAL KUMAR M,Independent,543,1,544,0.25
Manapparai,20,PRASANNA KUMAR P,Independent,113,0,113,0.05
Manapparai,21,RASU P,Independent,169,0,169,0.08
Manapparai,22,JEYAPANDIAN D,Independent,93,0,93,0.04
Manapparai,23,NOTA,None of the Above,1002,7,1009,0.46
Mannargudi,1,RAJAMANICKAM  SIVA,All India Anna Dravida Munnetra Kazhagam,49570,209,49779,25.76
Mannargudi,2,RAJAA T R B,Dravida Munnetra Kazhagam,86071,1101,87172,45.11
Mannargudi,3,ARAVINDAN RAMA,Naam Tamilar Katchi,10398,40,10438,5.4
Mannargudi,4,ANBANANDAM S,Makkal Needhi Maiam,1358,8,1366,0.71
Mannargudi,5,KAMARAJ S,Amma Makkal Munnettra Kazagam,40271,210,40481,20.95
Mannargudi,6,SATHISKUMAR S,Puthiya Tamilagam,584,4,588,0.3
Mannargudi,7,KUMARESAN T,Independent,1837,8,1845,0.95
Mannargudi,8,BARADHIDASAN T,Independent,95,2,97,0.05
Mannargudi,9,MARIMUTHU A.V.M,Independent,124,1,125,0.06
Mannargudi,10,MURUGAN S,Independent,376,2,378,0.2
Mannargudi,11,NOTA,None of the Above,955,5,960,0.5
Mayiladuthurai,1,Shamsudeen.N,Bahujan Samaj Party,523,3,526,0.3
Mayiladuthurai,2,Rajakumar.S,Indian National Congress,72376,1266,73642,42.17
Mayiladuthurai,3,Anbarasan Komal R K,Amma Makkal Munnettra Kazagam,7205,77,7282,4.17
Mayiladuthurai,4,Kasiraman.K,Naam Tamilar Katchi,13123,63,13186,7.55
Mayiladuthurai,5,Palanisamy.A,Pattali Makkal Katchi,70310,590,70900,40.6
Mayiladuthurai,6,Ravichandran.N,Makkal Needhi Maiam,5850,83,5933,3.4
Mayiladuthurai,7,Rajkumar.S,Tamil Nadu Ilangyar Katchi,645,6,651,0.37
Mayiladuthurai,8,Ganesan.S,Independent,185,0,185,0.11
Mayiladuthurai,9,Loga.Sampath,Independent,152,3,155,0.09
Mayiladuthurai,10,Thimothy.T,Independent,135,3,138,0.08
Mayiladuthurai,11,Niranjan.R,Independent,242,1,243,0.14
Mayiladuthurai,12,Babusankar.R,Independent,167,1,168,0.1
Mayiladuthurai,13,Manimaran.T,Independent,206,2,208,0.12
Mayiladuthurai,14,Rajendran.M,Independent,356,0,356,0.2
Mayiladuthurai,15,NOTA,None of the Above,1054,13,1067,0.61
Melur,1,RAVICHANDRAN  T.,Indian National Congress,47727,455,48182,26.36
Melur,2,PERIYAPULLAN @ SELVAM  P.,All India Anna Dravida Munnetra Kazhagam,83126,218,83344,45.6
Melur,3,KATHIRESAN  K.,Makkal Needhi Maiam,2161,15,2176,1.19
Melur,4,KARUPPUSAMY  P.,Naam Tamilar Katchi,10606,63,10669,5.84
Melur,5,SENTHILRAJ  K.,My India Party,270,0,270,0.15
Melur,6,SELVARAJ  A.,Amma Makkal Munnettra Kazagam,34027,235,34262,18.74
Melur,7,KANNAN  P.,Independent,257,1,258,0.14
Melur,8,GOBALAKRISHNAN  M.,Independent,350,0,350,0.19
Melur,9,SIVASAMY  R.,Independent,109,1,110,0.06
Melur,10,DHARMAR  P.,Independent,95,0,95,0.05
Melur,11,DHINAKARAN  S.,Independent,274,0,274,0.15
Melur,12,NAGENDRAN  N.,Independent,199,1,200,0.11
Melur,13,PANDI  K.,Independent,736,0,736,0.4
Melur,14,BALAN  T.,Independent,630,0,630,0.34
Melur,15,MOHANRAM  C.,Independent,342,0,342,0.19
Melur,16,NOTA,None of the Above,875,9,884,0.48
Mettuppalayam,1,SHANMUGASUNDARAM T R,Dravida Munnetra Kazhagam,101451,1324,102775,45.66
Mettuppalayam,2,SELVARAJ A K,All India Anna Dravida Munnetra Kazhagam,104632,599,105231,46.75
Mettuppalayam,3,SARAVANAN P,Amma Makkal Munnettra Kazagam,1856,8,1864,0.83
Mettuppalayam,4,MAHESHWARAN K,Veerath Thiyagi Viswanathadoss Thozhilalarkal Katchi,274,0,274,0.12
Mettuppalayam,5,YASMIN K,Naam Tamilar Katchi,10900,54,10954,4.87
Mettuppalayam,6,SHANMUGASUNDARAM K,Independent,115,0,115,0.05
Mettuppalayam,7,SHANMUGASUNDARAM P,Independent,184,0,184,0.08
Mettuppalayam,8,MARIAPPAN T,Independent,110,0,110,0.05
Mettuppalayam,9,LIAKATHALI O,Independent,182,1,183,0.08
Mettuppalayam,10,SRINIVASAN S,Independent,653,7,660,0.29
Mettuppalayam,11,NOTA,None of the Above,2701,32,2733,1.21
Mettur,1,SRINIVASAPERUMAL.S,Dravida Munnetra Kazhagam,94437,1962,96399,44.13
Mettur,2,RAMESH ARAVIND.M,Desiya Murpokku Dravida Kazhagam,1860,14,1874,0.86
Mettur,3,ANUSUYA.P,Makkal Needhi Maiam,4549,56,4605,2.11
Mettur,4,SADHASIVAM.S,Pattali Makkal Katchi,95795,1260,97055,44.43
Mettur,5,THANGAVEL. K,Dhesiya Makkal Kazhagam,1781,2,1783,0.82
Mettur,6,BANUPRIYA.P,Ganasangam Party of India,434,1,435,0.2
Mettur,7,MANIKANDAN.C,Naam Tamilar Katchi,9004,105,9109,4.17
Mettur,8,RASAPPAN.K,My India Party,226,0,226,0.1
Mettur,9,AMBIKA.A,Independent,732,6,738,0.34
Mettur,10,ARIVAZHAGAN.P,Independent,166,2,168,0.08
Mettur,11,SADHASIVAM.P,Independent,383,3,386,0.18
Mettur,12,SELVAN,Independent,2817,6,2823,1.29
Mettur,13,SEKAR.P,Independent,266,3,269,0.12
Mettur,14,Dr.PADMARAJAN.K,Independent,321,4,325,0.15
Mettur,15,NOTA,None of the Above,2239,8,2247,1.03
Modakkurichi,1,SARASWATHI.C,Bharatiya Janata Party,77653,472,78125,42.96
Modakkurichi,2,SUBBULAKSHMI JEGADEESAN,Dravida Munnetra Kazhagam,76409,1435,77844,42.81
Modakkurichi,3,BOOPATHI.R,Bahujan Samaj Party,1136,7,1143,0.63
Modakkurichi,4,THANGARAJ.D,Amma Makkal Munnettra Kazagam,1539,8,1547,0.85
Modakkurichi,5,PRAKASH.G,Naam Tamilar Katchi,12871,73,12944,7.12
Modakkurichi,6,MAHESWARAN .A,My India Party,288,7,295,0.16
Modakkurichi,7,MANI.P,India Dravida Makkal Munnetra Katchi,119,0,119,0.07
Modakkurichi,8,MANICKAM.R,Ganasangam Party of India,326,1,327,0.18
Modakkurichi,9,RAMESH.M,Namathu Kongu Munnetra Kalagam,230,5,235,0.13
Modakkurichi,10,RAJESHKUMAR.M,Makkal Needhi Maiam,4555,19,4574,2.52
Modakkurichi,11,GOVANAM THANGAVEL.K.S,Independent,300,1,301,0.17
Modakkurichi,12,SAMI KANDHASAMY,Independent,881,1,882,0.48
Modakkurichi,13,BHARATHI.L,Independent,273,2,275,0.15
Modakkurichi,14,MAYILSAMY.P,Independent,335,0,335,0.18
Modakkurichi,15,VIJAYAKUMAR.M,Independent,562,7,569,0.31
Modakkurichi,16,NOTA,None of the Above,2332,10,2342,1.29
Mudhukulathur,1,KEERTHIKA,All India Anna Dravida Munnetra Kazhagam,80166,1014,81180,36.7
Mudhukulathur,2,N.SIVANANDAM,Bahujan Samaj Party,533,2,535,0.24
Mudhukulathur,3,R.S.RAJAKANNAPPAN,Dravida Munnetra Kazhagam,100328,1573,101901,46.06
Mudhukulathur,4,A.SARAVANAKUMAR,Naam Indiar Party,609,5,614,0.28
Mudhukulathur,5,C.NAVAPANNEERSELVAM,Makkal Needhi Maiam,923,20,943,0.43
Mudhukulathur,6,K.PANCHATCHARAM,My India Party,133,1,134,0.06
Mudhukulathur,7,K.BOOMIRAJAN YADAV,Tamilaga Makkal Thannurimai Katchi,212,2,214,0.1
Mudhukulathur,8,C.MALAISELVAM,Puthiya Tamilagam,383,10,393,0.18
Mudhukulathur,9,M.MURUGAN,Amma Makkal Munnettra Kazagam,19403,266,19669,8.89
Mudhukulathur,10,R.RAHMADNISHA,Naam Tamilar Katchi,11099,145,11244,5.08
Mudhukulathur,11,S.RAJA,People's Party of India(secular),114,0,114,0.05
Mudhukulathur,12,T.AZHAKUMALAI KUMARAN,Independent,127,4,131,0.06
Mudhukulathur,13,S.IMMANUVEL SEKAR,Independent,197,1,198,0.09
Mudhukulathur,14,K.RAMACHANDRAN,Independent,390,0,390,0.18
Mudhukulathur,15,M.KARTHICK,Independent,140,1,141,0.06
Mudhukulathur,16,K.SATHISH,Independent,807,6,813,0.37
Mudhukulathur,17,G.M.SENTHILMURUGAN,Independent,708,5,713,0.32
Mudhukulathur,18,DEVA SITHAM.I,Independent,199,5,204,0.09
Mudhukulathur,19,S.PRABAKARAN,Independent,546,2,548,0.25
Mudhukulathur,20,K.MURUGAN,Independent,327,0,327,0.15
Mudhukulathur,21,P.MURUGAN,Independent,92,1,93,0.04
Mudhukulathur,22,E.MOHAN,Independent,82,0,82,0.04
Mudhukulathur,23,K.RAJAKUMAR,Independent,109,0,109,0.05
Mudhukulathur,24,NOTA,None of the Above,521,2,523,0.24
Musiri,1,Kumar.K.S,Desiya Murpokku Dravida Kazhagam,3153,29,3182,1.77
Musiri,2,M. Selvarasu,All India Anna Dravida Munnetra Kazhagam,63179,609,63788,35.5
Musiri,3,N. Thiyagarajan,Dravida Munnetra Kazhagam,88487,2137,90624,50.43
Musiri,4,V. Bernardshaw,Bahujan Samaj Party,458,0,458,0.25
Musiri,5,S. Gokul,Makkal Needhi Maiam,2467,32,2499,1.39
Musiri,6,Gautham. S,Rashtriya Samaj Paksha,251,2,253,0.14
Musiri,7,D. Dharmalingam,Samaniya Makkal Nala Katchi,109,1,110,0.06
Musiri,8,Sridevi Ilangovan,Naam Tamilar Katchi,14207,104,14311,7.96
Musiri,9,N. Aravan,Independent,108,0,108,0.06
Musiri,10,R. Anandhan,Independent,103,1,104,0.06
Musiri,11,Devanur Karthick,Independent,227,0,227,0.13
Musiri,12,Shanmugam,Independent,361,2,363,0.2
Musiri,13,"A.Chandran. M.Sc.,",Independent,174,1,175,0.1
Musiri,14,N. Saminathan,Independent,313,4,317,0.18
Musiri,15,N. Sivakumar,Independent,513,0,513,0.29
Musiri,16,T. Senthil Kumar,Independent,497,0,497,0.28
Musiri,17,V. Natarajan,Independent,164,0,164,0.09
Musiri,18,T. Periyathambi,Independent,462,1,463,0.26
Musiri,19,R. Michael,Independent,297,0,297,0.17
Musiri,20,"P. Loganathan. M.sc.,",Independent,160,1,161,0.09
Musiri,21,NOTA,None of the Above,1081,11,1092,0.61
Mylapore,1,NATARAJ.R,All India Anna Dravida Munnetra Kazhagam,55466,293,55759,36.34
Mylapore,2,BALAJI,Bahujan Samaj Party,410,3,413,0.27
Mylapore,3,VELU.DHA,Dravida Munnetra Kazhagam,67919,473,68392,44.58
Mylapore,4,KARTHICK.D,Amma Makkal Munnettra Kazagam,1113,5,1118,0.73
Mylapore,5,SENTHIL KUMAR.D,Anaithu Makkal Arasiyal Katchi,82,0,82,0.05
Mylapore,6,MAHALAKSHMI.K,Naam Tamilar Katchi,10098,26,10124,6.6
Mylapore,7,MOHANRAJ.J,Jebamani Janata,113,0,113,0.07
Mylapore,8,SRIPRIYA,Makkal Needhi Maiam,14850,54,14904,9.71
Mylapore,9,ARUNRAJ BALAN,Independent,76,0,76,0.05
Mylapore,10,KAJENDRAN.M,Independent,35,3,38,0.02
Mylapore,11,KUPPUSWAMY.T.M,Independent,26,0,26,0.02
Mylapore,12,SHANMUGARAJAN B,Independent,35,0,35,0.02
Mylapore,13,SELVAKUMAR,Independent,112,0,112,0.07
Mylapore,14,NATARAJAN P,Independent,127,2,129,0.08
Mylapore,15,NANDAGOPAL.G,Independent,85,2,87,0.06
Mylapore,16,NALLAPPAN.G,Independent,181,0,181,0.12
Mylapore,17,PASUPATHI PRAGALATHAN,Independent,117,0,117,0.08
Mylapore,18,MALAR KANNAN.R,Independent,29,0,29,0.02
Mylapore,19,RANGARAJAN.R,Independent,93,0,93,0.06
Mylapore,20,RADHA M (TRANSGENDER),Independent,203,0,203,0.13
Mylapore,21,VARATHARAJAN.V.S,Independent,49,1,50,0.03
Mylapore,22,V. VIJAYA KRISHNA,Independent,38,0,38,0.02
Mylapore,23,VENKATESH,Independent,24,0,24,0.02
Mylapore,24,NOTA,None of the Above,1279,8,1287,0.84
Nagapattinam,1,Thanka.kathiravan,All India Anna Dravida Munnetra Kazhagam,58729,314,59043,41.13
Nagapattinam,2,S.Augustine Arputharaj,Naam Tamilar Katchi,9931,45,9976,6.95
Nagapattinam,3,T. Singaravadivelan,Shiv Sena,105,0,105,0.07
Nagapattinam,4,Syed Anas Mohideen Sahip,Makkal Needhi Maiam,2523,17,2540,1.77
Nagapattinam,5,J.V. Durai,Makkalatchi Katchi,96,2,98,0.07
Nagapattinam,6,C.Manjula,Amma Makkal Munnettra Kazagam,3457,46,3503,2.44
Nagapattinam,7,Mayilarasi,Naadaalum Makkal Katchi,256,0,256,0.18
Nagapattinam,8,J. Mohamed Shanavas,Viduthalai Chiruthaigal Katchi,65587,694,66281,46.17
Nagapattinam,9,V. Canagaradjou,Independent,208,1,209,0.15
Nagapattinam,10,Durai. Selvakumar,Independent,110,3,113,0.08
Nagapattinam,11,N P Bhashgaran,Independent,180,4,184,0.13
Nagapattinam,12,S. Prem,Independent,105,0,105,0.07
Nagapattinam,13,V. Manikandan,Independent,252,0,252,0.18
Nagapattinam,14,NOTA,None of the Above,893,2,895,0.62
Nagercoil,1,Gandhi M.R.,Bharatiya Janata Party,87805,999,88804,48.21
Nagercoil,2,Suresh Rajan N.,Dravida Munnetra Kazhagam,75387,1748,77135,41.88
Nagercoil,3,Ammu Anto I.,Amma Makkal Munnettra Kazagam,1079,15,1094,0.59
Nagercoil,4,Satheesh Kumar D.,Anaithu Makkal Arasiyal Katchi,70,0,70,0.04
Nagercoil,5,Sunil Kumar S.,Anaithu Makkal Puratchi Katchi,314,1,315,0.17
Nagercoil,6,Maria Jacob Stani Raja S.,Makkal Needhi Maiam,4007,30,4037,2.19
Nagercoil,7,Vijayaragavan,Naam Tamilar Katchi,10666,87,10753,5.84
Nagercoil,8,Usha P.,Independent,132,2,134,0.07
Nagercoil,9,Kannan M.,Independent,102,1,103,0.06
Nagercoil,10,Gandhi L.,Independent,73,0,73,0.04
Nagercoil,11,Gandhi Raj C.,Independent,182,1,183,0.1
Nagercoil,12,Bala Sivanesan J.,Independent,238,4,242,0.13
Nagercoil,13,Pravin Raj P.,Independent,97,0,97,0.05
Nagercoil,14,Mahizhchi P.,Independent,80,1,81,0.04
Nagercoil,15,Rathinam A.T.,Independent,133,1,134,0.07
Nagercoil,16,NOTA,None of the Above,919,11,930,0.5
Namakkal,1,RAMASAMY P,Bahujan Samaj Party,254,7,261,0.13
Namakkal,2,SARAVANAN A,National People's Party,130,2,132,0.06
Namakkal,3,SELVI K,Desiya Murpokku Dravida Kazhagam,960,12,972,0.47
Namakkal,4,BASKAR K.P.P.,All India Anna Dravida Munnetra Kazhagam,77043,1590,78633,38.03
Namakkal,5,RAMALINGAM P,Dravida Munnetra Kazhagam,103480,3014,106494,51.51
Namakkal,6,ADHAM FAROOK S,Makkal Needhi Maiam,5530,59,5589,2.7
Namakkal,7,RAMESH T,Ahimsa Socialist Party,307,6,313,0.15
Namakkal,8,KANAKARAJ K,Ganasangam Party of India,169,6,175,0.08
Namakkal,9,SARAVANAN S,Naadaalum Makkal Katchi,57,1,58,0.03
Namakkal,10,SIVAKUMAR D,Anna Puratchi Thalaivar Amma Dravida Munnetra Kazhagam,76,2,78,0.04
Namakkal,11,SELVAKUMAR E,Manitha Urimaigal Kalaagam,144,5,149,0.07
Namakkal,12,TAMIZHVANAN K,Tamilaga Makkal Thannurimai Katchi,428,5,433,0.21
Namakkal,13,THIYAGARAJAN R,Samaniya Makkal Nala Katchi,189,4,193,0.09
Namakkal,14,BASKAR B,Naam Tamilar Katchi,10008,114,10122,4.9
Namakkal,15,MADHESWARAN A.S,My India Party,113,1,114,0.06
Namakkal,16,ARUL SELVAN,Independent,287,4,291,0.14
Namakkal,17,ANBUMANI,Independent,220,3,223,0.11
Namakkal,18,KUPPUSAMY M,Independent,43,2,45,0.02
Namakkal,19,SURESH KUMAR L,Independent,104,3,107,0.05
Namakkal,20,SELVAKUMAR R,Independent,197,1,198,0.1
Namakkal,21,CHO V,Independent,252,1,253,0.12
Namakkal,22,DEEPAN CHAKKRAVARTHI S,Independent,247,2,249,0.12
Namakkal,23,MUTHUSAMY S,Independent,84,3,87,0.04
Namakkal,24,RAMALINGAM K,Independent,114,4,118,0.06
Namakkal,25,JAWAHAR,Independent,85,1,86,0.04
Namakkal,26,JAYARAMACHANDRAN P,Independent,100,1,101,0.05
Namakkal,27,NOTA,None of the Above,1266,19,1285,0.62
Nanguneri,1,GANESARAJA,All India Anna Dravida Munnetra Kazhagam,59045,371,59416,30.86
Nanguneri,2,SUBBULAKSHMI,Bahujan Samaj Party,697,3,700,0.36
Nanguneri,3,RUBY R MANOHARAN,Indian National Congress,74493,1409,75902,39.43
Nanguneri,4,KANDHAN,Anaithu Ulaga Tamilargal Munnetra Kalagam,495,2,497,0.26
Nanguneri,5,SHUNMUGA SUNDARAM,Naam Indiar Party,441,0,441,0.23
Nanguneri,6,PARAMASIVA IYYAPPAN,Amma Makkal Munnettra Kazagam,31708,162,31870,16.55
Nanguneri,7,PRABAKARAN,Veerath Thiyagi Viswanathadoss Thozhilalarkal Katchi,429,1,430,0.22
Nanguneri,8,VEERAPANDI,Naam Tamilar Katchi,17543,111,17654,9.17
Nanguneri,9,ASHOK KUMAR,Independent,619,6,625,0.32
Nanguneri,10,KATHIRAVAN,Independent,1151,3,1154,0.6
Nanguneri,11,KANDASAMY,Independent,428,4,432,0.22
Nanguneri,12,GNANA BALAJI,Independent,806,7,813,0.42
Nanguneri,13,MUTHUDURAI,Independent,160,1,161,0.08
Nanguneri,14,MUTHURAJ,Independent,434,2,436,0.23
Nanguneri,15,LENIN,Independent,449,5,454,0.24
Nanguneri,16,NOTA,None of the Above,1531,6,1537,0.8
Nannilam,1,KAMARAJ R,All India Anna Dravida Munnetra Kazhagam,103236,401,103637,46.7
Nannilam,2,RAVICHANDRAN  R,Bahujan Samaj Party,711,0,711,0.32
Nannilam,3,JOTHIRAMAN  S,Dravida Munnetra Kazhagam,98409,804,99213,44.7
Nannilam,4,RAMACHANDRAN   N,Amma Makkal Munnettra Kazagam,2070,6,2076,0.94
Nannilam,5,GANESAN  D,Indiya Jananayaka Katchi,379,2,381,0.17
Nannilam,6,NITHIYANANTHAM  S,Anaithu Makkal Arasiyal Katchi,81,0,81,0.04
Nannilam,7,PANASAIARAGAN K N,Desiya Makkal Sakthi Katchi,111,0,111,0.05
Nannilam,8,FATHIMA FARHANA  S,Naam Tamilar Katchi,13377,42,13419,6.05
Nannilam,9,MURUGAVEL  M,Anna Dravidar Kazhagam,163,1,164,0.07
Nannilam,10,ANUSHA  T,Independent,203,3,206,0.09
Nannilam,11,KRISHNAN  K,Independent,46,1,47,0.02
Nannilam,12,KUMARAN  R,Independent,77,1,78,0.04
Nannilam,13,TAMILSELVAN  R,Independent,153,0,153,0.07
Nannilam,14,NATARAJAN  C,Independent,352,0,352,0.16
Nannilam,15,RAJA S,Independent,125,0,125,0.06
Nannilam,16,NOTA,None of the Above,1188,2,1190,0.54
Natham,1,M.A.ANDI AMBALAM,Dravida Munnetra Kazhagam,94968,862,95830,42.54
Natham,2,P.ANDISAMY,Bahujan Samaj Party,676,2,678,0.3
Natham,3,NATHAM.R.VISWANATHAN,All India Anna Dravida Munnetra Kazhagam,107255,507,107762,47.84
Natham,4,R.A.SARANRAJ,Indiya Jananayaka Katchi,1019,6,1025,0.46
Natham,5,DOCTOR.V.SIVASANKARAN,Naam Tamilar Katchi,14673,89,14762,6.55
Natham,6,N.RAJA,Amma Makkal Munnettra Kazagam,1713,8,1721,0.76
Natham,7,V.VEMBARASAN,My India Party,164,2,166,0.07
Natham,8,A.KARNAN,Independent,335,0,335,0.15
Natham,9,C.GURUSAMY,Independent,95,1,96,0.04
Natham,10,M.XAVIER JOSEPH KENNEDY,Independent,189,5,194,0.09
Natham,11,K.DHANDAPANI,Independent,321,1,322,0.14
Natham,12,A.BALASUBRAMANI,Independent,112,0,112,0.05
Natham,13,K.MURUGESAN,Independent,224,0,224,0.1
Natham,14,S.JEYAKUMAR,Independent,383,0,383,0.17
Natham,15,JEYAPAUL R,Independent,190,0,190,0.08
Natham,16,NOTA,None of the Above,1438,6,1444,0.64
Neyveli,1,KANAGARAJI.C,Bahujan Samaj Party,450,5,455,0.28
Neyveli,2,SABA.RAJENDRAN,Dravida Munnetra Kazhagam,74189,988,75177,45.8
Neyveli,3,ILANGOVAN.R,Indiya Jananayaka Katchi,1006,5,1011,0.62
Neyveli,4,BAKTHARATCHAGAN.R,Amma Makkal Munnettra Kazagam,2221,9,2230,1.36
Neyveli,5,RAMESH.K,Naam Tamilar Katchi,7763,22,7785,4.74
Neyveli,6,JAGAN.K,Pattali Makkal Katchi,73544,656,74200,45.21
Neyveli,7,DHANASEKARAN.S,Independent,333,1,334,0.2
Neyveli,8,DHILIBAN.U,Independent,392,0,392,0.24
Neyveli,9,DHURGA.K,Independent,204,5,209,0.13
Neyveli,10,BOOBALAN.E,Independent,91,0,91,0.06
Neyveli,11,RAJENDRAN .B,Independent,552,4,556,0.34
Neyveli,12,VADUGANATHAN.R,Independent,519,0,519,0.32
Neyveli,13,NOTA,None of the Above,1164,7,1171,0.71
Nilakkottai,1,K.Ramasamy,Desiya Murpokku Dravida Kazhagam,3684,20,3704,2
Nilakkottai,2,S.Thenmozhi,All India Anna Dravida Munnetra Kazhagam,90857,604,91461,49.49
Nilakkottai,3,P.Nagendran,Bahujan Samaj Party,664,2,666,0.36
Nilakkottai,4,K.Murugavelrajan,Dravida Munnetra Kazhagam,62593,1250,63843,34.55
Nilakkottai,5,V.K.Aiyyar,Puthiya Tamilagam,478,6,484,0.26
Nilakkottai,6,Ananth,Makkal Needhi Maiam,3146,35,3181,1.72
Nilakkottai,7,V.Revadhi,My India Party,155,3,158,0.09
Nilakkottai,8,G.Vasanthadevi,Naam Tamilar Katchi,17363,142,17505,9.47
Nilakkottai,9,A.Alappan,Independent,340,3,343,0.19
Nilakkottai,10,M.Kalimuthu,Independent,61,0,61,0.03
Nilakkottai,11,P.Sivakami,Independent,76,1,77,0.04
Nilakkottai,12,P.Nagajothi,Independent,511,4,515,0.28
Nilakkottai,13,S.Nithya,Independent,126,2,128,0.07
Nilakkottai,14,M.Pandi,Independent,135,2,137,0.07
Nilakkottai,15,V.Balasubramani,Independent,163,1,164,0.09
Nilakkottai,16,N.Perumal,Independent,252,0,252,0.14
Nilakkottai,17,P.Pothumanickam,Independent,372,3,375,0.2
Nilakkottai,18,V.Vinoth,Independent,491,0,491,0.27
Nilakkottai,19,NOTA,None of the Above,1248,12,1260,0.68
Oddanchatram,1,SAKKARAPANI R,Dravida Munnetra Kazhagam,108990,980,109970,54.51
Oddanchatram,2,SIVA KUMAR M,Desiya Murpokku Dravida Kazhagam,1417,10,1427,0.71
Oddanchatram,3,NATARAJ N.P,All India Anna Dravida Munnetra Kazhagam,80819,409,81228,40.26
Oddanchatram,4,MURUGARAJ P,Bahujan Samaj Party,527,2,529,0.26
Oddanchatram,5,ABDUL HADI A,Makkal Needhi Maiam,1069,13,1082,0.54
Oddanchatram,6,SAKTHI DEVI T,Naam Tamilar Katchi,4892,52,4944,2.45
Oddanchatram,7,RAVI M,Anaithu Makkal Puratchi Katchi,61,0,61,0.03
Oddanchatram,8,RAVICHANDRAN K,My India Party,52,0,52,0.03
Oddanchatram,9,SHANMUGAVEL P,Independent,40,0,40,0.02
Oddanchatram,10,SIVAPRAKASH S,Independent,44,0,44,0.02
Oddanchatram,11,SIVANESAN K,Independent,59,0,59,0.03
Oddanchatram,12,CHELLAMUTHU K,Independent,100,0,100,0.05
Oddanchatram,13,BALASUBRAMANI S,Independent,356,0,356,0.18
Oddanchatram,14,MARIMUTHU T.S,Independent,406,1,407,0.2
Oddanchatram,15,NOTA,None of the Above,1451,6,1457,0.72
Omalur,1,N.V.THOMAS,Bahujan Samaj Party,804,8,812,0.33
Omalur,2,R.MANI,All India Anna Dravida Munnetra Kazhagam,141527,961,142488,57.22
Omalur,3,RANGARAJAN MOHAN KUMARAMANGALAM,Indian National Congress,85826,1368,87194,35.01
Omalur,4,M.KARUNAKARAN,Tamil Nadu Ilangyar Katchi,1204,24,1228,0.49
Omalur,5,V.SRINIVASAN,Makkal Needhi Maiam,2888,42,2930,1.18
Omalur,6,S.DHIVYA,Dhesiya Makkal Kazhagam,277,4,281,0.11
Omalur,7,K.K.MADHESWARAN,Amma Makkal Munnettra Kazagam,1188,14,1202,0.48
Omalur,8,A.RAJA,Naam Tamilar Katchi,9341,75,9416,3.78
Omalur,9,K.GOVINDARAJU,Independent,116,2,118,0.05
Omalur,10,T.SURESH,Independent,104,0,104,0.04
Omalur,11,E.MANI,Independent,104,7,111,0.04
Omalur,12,S.MANI,Independent,144,5,149,0.06
Omalur,13,R.MANI,Independent,282,2,284,0.11
Omalur,14,R.MURUGAN,Independent,676,0,676,0.27
Omalur,15,P.RAJA,Independent,433,1,434,0.17
Omalur,16,NOTA,None of the Above,1581,19,1600,0.64
Orathanadu,1,"RAMCHANDRAN, M.",Dravida Munnetra Kazhagam,60471,757,61228,31.92
Orathanadu,2,"VAITHILINGAM, R.",All India Anna Dravida Munnetra Kazhagam,89516,547,90063,46.95
Orathanadu,3,"STALIN, R.",Bahujan Samaj Party,550,0,550,0.29
Orathanadu,4,"KANDHASAMY, M.",Naam Tamilar Katchi,9013,37,9050,4.72
Orathanadu,5,"SEKAR, M.",Amma Makkal Munnettra Kazagam,25854,168,26022,13.56
Orathanadu,6,"THANRAJ, R.",United States of India Party,229,0,229,0.12
Orathanadu,7,"PRABAKARAN, U.",Anaithu Makkal Puratchi Katchi,99,0,99,0.05
Orathanadu,8,"RENGASAMY, G.",Makkal Needhi Maiam,709,12,721,0.38
Orathanadu,9,"ARUNKUMAR, K.",Independent,220,3,223,0.12
Orathanadu,10,"MOOKKAIYAN, V.",Independent,2031,10,2041,1.06
Orathanadu,11,"RENGARAJ, S.",Independent,317,2,319,0.17
Orathanadu,12,"JAYASOORIYAN, T.",Independent,428,0,428,0.22
Orathanadu,13,NOTA,None of the Above,861,6,867,0.45
Ottapidaram,1,ARUMUGANAINAR S,Desiya Murpokku Dravida Kazhagam,5276,51,5327,3
Ottapidaram,2,SHUNMUGAIAH C,Dravida Munnetra Kazhagam,71605,1505,73110,41.11
Ottapidaram,3,MOHAN P,All India Anna Dravida Munnetra Kazhagam,63907,693,64600,36.32
Ottapidaram,4,ARUNADEVI R,Indiya Jananayaka Katchi,1890,23,1913,1.08
Ottapidaram,5,Dr.K.KRISHNASAMY,Puthiya Tamilagam,6418,126,6544,3.68
Ottapidaram,6,MAHARAJAN A,Bahujan Dravida Party,155,2,157,0.09
Ottapidaram,7,MURUGAN P,Naam Indiar Party,517,3,520,0.29
Ottapidaram,8,VAIKUNDAMARI M,Naam Tamilar Katchi,22104,309,22413,12.6
Ottapidaram,9,ELAMBIRAI MANIMARAN P,Independent,148,4,152,0.09
Ottapidaram,10,GANESHKUMAR M,Independent,83,1,84,0.05
Ottapidaram,11,KARUPPARAJA,Independent,84,2,86,0.05
Ottapidaram,12,GUNASEKARAN,Independent,97,3,100,0.06
Ottapidaram,13,SASI MURUGAN C,Independent,133,0,133,0.07
Ottapidaram,14,SAMUTHIRAM P,Independent,396,3,399,0.22
Ottapidaram,15,M.A.DHARMAR,Independent,318,2,320,0.18
Ottapidaram,16,RAJ V,Independent,315,1,316,0.18
Ottapidaram,17,VELMURUGAN,Independent,98,0,98,0.06
Ottapidaram,18,NOTA,None of the Above,1540,28,1568,0.88
Padmanabhapuram,1,"Mano Thangaraj, T.",Dravida Munnetra Kazhagam,86193,1551,87744,51.57
Padmanabhapuram,2,"Latha, P.",Bahujan Samaj Party,1253,19,1272,0.75
Padmanabhapuram,3,"John Thankam, D.",All India Anna Dravida Munnetra Kazhagam,60100,759,60859,35.77
Padmanabhapuram,4,Seelan,Naam Tamilar Katchi,13709,190,13899,8.17
Padmanabhapuram,5,"Jenkins, D.",Amma Makkal Munnettra Kazagam,3192,42,3234,1.9
Padmanabhapuram,6,"Jeyaraj, M.",Makkal Needhi Maiam,962,19,981,0.58
Padmanabhapuram,7,"Anchalose, Y.",Independent,55,0,55,0.03
Padmanabhapuram,8,"Glory Selvi, T.",Independent,262,9,271,0.16
Padmanabhapuram,9,"SyedAli, A.",Independent,321,3,324,0.19
Padmanabhapuram,10,"Nagarajan, M.",Independent,128,1,129,0.08
Padmanabhapuram,11,"Mathan, F.",Independent,173,4,177,0.1
Padmanabhapuram,12,"Robert Singh, I.",Independent,175,0,175,0.1
Padmanabhapuram,13,NOTA,None of the Above,1023,13,1036,0.61
Palacode,1,HARI.R.,Bahujan Samaj Party,580,5,585,0.28
Palacode,2,ANBALAGAN.K.P.,All India Anna Dravida Munnetra Kazhagam,109105,965,110070,53.28
Palacode,3,MURUGAN.P.K.,Dravida Munnetra Kazhagam,81035,935,81970,39.68
Palacode,4,VIJAYASANKAR.P.,Desiya Murpokku Dravida Kazhagam,2394,15,2409,1.17
Palacode,5,KALAISELVI.G.,Naam Tamilar Katchi,7647,57,7704,3.73
Palacode,6,RAJASEKAR.D.,Makkal Needhi Maiam,1168,8,1176,0.57
Palacode,7,ANBARASU.D.,Independent,79,1,80,0.04
Palacode,8,SHARAVANAN.M.P.,Independent,90,0,90,0.04
Palacode,9,MURUGAN.K.,Independent,115,5,120,0.06
Palacode,10,MURUGAN.K.G.,Independent,169,0,169,0.08
Palacode,11,RAJKUMAR.T.,Independent,406,0,406,0.2
Palacode,12,VADIVEL.M.,Independent,464,1,465,0.23
Palacode,13,NOTA,None of the Above,1348,3,1351,0.65
Palani,1,SENTHIL KUMAR I.P,Dravida Munnetra Kazhagam,107049,1517,108566,52.86
Palani,2,NACHIMUTHU S,Bahujan Samaj Party,442,1,443,0.22
Palani,3,RAVI MANOHARAN K,All India Anna Dravida Munnetra Kazhagam,77951,559,78510,38.23
Palani,4,SIVABALA MOORTHI K,Akhil Bharat Hindu Mahasabha,598,3,601,0.29
Palani,5,THANGAVEL B,My India Party,76,1,77,0.04
Palani,6,POOVENDHAN T,Makkal Needhi Maiam,3669,63,3732,1.82
Palani,7,VINOTH RAJASEKARAN G,Naam Tamilar Katchi,7563,93,7656,3.73
Palani,8,VEERAKUMAR V,Amma Makkal Munnettra Kazagam,2231,24,2255,1.1
Palani,9,AZHAGUMALAI A,Independent,43,0,43,0.02
Palani,10,ANANTHAN S. P,Independent,92,0,92,0.04
Palani,11,KARUPPUSAMY P,Independent,37,1,38,0.02
Palani,12,KALIAPPAN K,Independent,47,2,49,0.02
Palani,13,SHAHUL HAMEED,Independent,147,2,149,0.07
Palani,14,SAMIAPPA GOUNDER P,Independent,195,0,195,0.09
Palani,15,SIDDIQ M,Independent,110,0,110,0.05
Palani,16,SUDHA R B,Independent,520,2,522,0.25
Palani,17,SURESH M,Independent,462,0,462,0.22
Palani,18,THANGAVEL A,Independent,58,0,58,0.03
Palani,19,NAGENDRAN G,Independent,308,2,310,0.15
Palani,20,PANDEESWARAN M,Independent,68,0,68,0.03
Palani,21,PERIYADURAI M,Independent,94,1,95,0.05
Palani,22,MUNISHRAJA M,Independent,73,0,73,0.04
Palani,23,RASULBEEVI SAHABUDEEN,Independent,64,0,64,0.03
Palani,24,LATHIKA,Independent,105,1,106,0.05
Palani,25,NOTA,None of the Above,1088,22,1110,0.54
Palayamkottai,1,ABDUL WAHAB .M,Dravida Munnetra Kazhagam,86869,2248,89117,55.32
Palayamkottai,2,GERALD .G,All India Anna Dravida Munnetra Kazhagam,36393,583,36976,22.95
Palayamkottai,3,FATHIMA .A,Naam Tamilar Katchi,11515,150,11665,7.24
Palayamkottai,4,PREMNATH. D,Makkal Needhi Maiam,8002,105,8107,5.03
Palayamkottai,5,MOHAMED MUBARAK .V.M.S.,SOCIAL DEMOCRATIC PARTY OF INDIA,12126,115,12241,7.6
Palayamkottai,6,RAJA .S,Veerath Thiyagi Viswanathadoss Thozhilalarkal Katchi,294,4,298,0.18
Palayamkottai,7,VEERASUBRAMANIYAN .S,Aanaithinthiya Jananayaka Pathukappu Kazhagam,226,5,231,0.14
Palayamkottai,8,SADAGOPAN .K,Independent,387,8,395,0.25
Palayamkottai,9,LEO INFANT RAJ .M,Independent,195,7,202,0.13
Palayamkottai,10,JOHN SAMUVEL JESUPATHAM .D,Independent,209,3,212,0.13
Palayamkottai,11,NOTA,None of the Above,1620,27,1647,1.02
Palladam,1,ANNADURAI R,Bahujan Samaj Party,607,3,610,0.23
Palladam,2,ANANDAN M S M,All India Anna Dravida Munnetra Kazhagam,126437,466,126903,48.53
Palladam,3,MUTHURATHINAM K,Dravida Munnetra Kazhagam,93216,996,94212,36.03
Palladam,4,ANTONY MARIARAJ A,Tamil Nadu Ilangyar Katchi,530,0,530,0.2
Palladam,5,UMANATH R,United States of India Party,307,2,309,0.12
Palladam,6,SIVAKUMAR G,Anna Puratchi Thalaivar Amma Dravida Munnetra Kazhagam,162,0,162,0.06
Palladam,7,SUBRAMANIAN S,Naam Tamilar Katchi,20470,54,20524,7.85
Palladam,8,THINAKARAN K,Anna Dravidar Kazhagam,130,0,130,0.05
Palladam,9,MAYILSAMY G,Makkal Needhi Maiam,10195,32,10227,3.91
Palladam,10,JOTHIMANI R,Amma Makkal Munnettra Kazagam,2606,12,2618,1
Palladam,11,SHAHUL HAMEED M,Independent,86,0,86,0.03
Palladam,12,SARATHA T,Independent,112,0,112,0.04
Palladam,13,THANGARAJ A,Independent,212,3,215,0.08
Palladam,14,THUYAMANI R,Independent,690,3,693,0.26
Palladam,15,MARUTHASALAM V,Independent,365,0,365,0.14
Palladam,16,MUTHURATHINAM M,Independent,720,2,722,0.28
Palladam,17,MUTHURATHINAM L,Independent,171,0,171,0.07
Palladam,18,MURUGESAN K,Independent,584,3,587,0.22
Palladam,19,RAMESH V,Independent,314,1,315,0.12
Palladam,20,VIJIYAKUMAR M,Independent,214,4,218,0.08
Palladam,21,NOTA,None of the Above,1793,9,1802,0.69
Pallavaram,1,RAJENDRAN,All India Anna Dravida Munnetra Kazhagam,88312,334,88646,33.3
Pallavaram,2,KARUNANITHI,Dravida Munnetra Kazhagam,125705,722,126427,47.49
Pallavaram,3,KARTHICK,Bahujan Samaj Party,519,0,519,0.19
Pallavaram,4,MURUGESAN,Desiya Murpokku Dravida Kazhagam,3713,5,3718,1.4
Pallavaram,5,AJITHKUMAR,Puthiya Tamilagam,200,2,202,0.08
Pallavaram,6,KUMAR,Anna MGR Dravida Makkal Kalgam,58,1,59,0.02
Pallavaram,7,GOKULKRISHNAN,Tamil Nadu Ilangyar Katchi,430,2,432,0.16
Pallavaram,8,SASIKUMAR LAKSHMIPATHY,National Democratic Party of South India,84,1,85,0.03
Pallavaram,9,SATHYASEELAN,Lok Jan Shakti Party,232,2,234,0.09
Pallavaram,10,SENTHIL KUMAR,Makkal Needhi Maiam,20567,45,20612,7.74
Pallavaram,11,SERMA SELVARAJ,Desiya Makkal Sakthi Katchi,525,0,525,0.2
Pallavaram,12,MINISHREE KANAGARAJ,Naam Tamilar Katchi,21322,40,21362,8.02
Pallavaram,13,VEERALAKSHMI,My India Party,171,0,171,0.06
Pallavaram,14,SRIDHARAN,Dravida Murpokku Makkal Katchi,69,0,69,0.03
Pallavaram,15,KANAGARAJ,Independent,133,0,133,0.05
Pallavaram,16,KUMARA DOSS,Independent,274,0,274,0.1
Pallavaram,17,SADAM HUSSAIN,Independent,266,1,267,0.1
Pallavaram,18,BALAJI,Independent,166,1,167,0.06
Pallavaram,19,BHASKARAN,Independent,40,1,41,0.02
Pallavaram,20,PERUMAL,Independent,86,0,86,0.03
Pallavaram,21,MICHAEL,Independent,124,0,124,0.05
Pallavaram,22,RAMACHANDRAN.R,Independent,96,0,96,0.04
Pallavaram,23,NOTA,None of the Above,1935,10,1945,0.73
Panruti,1,RAJENDRAN.R,All India Anna Dravida Munnetra Kazhagam,88489,615,89104,45.22
Panruti,2,SIVAKOZHUNDU.P,Desiya Murpokku Dravida Kazhagam,3357,5,3362,1.71
Panruti,3,VELMURUGAN.T,Dravida Munnetra Kazhagam,92917,884,93801,47.6
Panruti,4,SUBHASHINI.R,Naam Tamilar Katchi,6511,36,6547,3.32
Panruti,5,JAYLANI,Makkal Needhi Maiam,1657,13,1670,0.85
Panruti,6,ARULKUMAR.R,Independent,159,0,159,0.08
Panruti,7,KAMADEVAN.S,Independent,69,0,69,0.04
Panruti,8,KRISHNARAJ.S,Independent,67,1,68,0.03
Panruti,9,KUMAR.D,Independent,45,3,48,0.02
Panruti,10,GOVINDASAMY.S,Independent,42,0,42,0.02
Panruti,11,SUMATHI.V,Independent,106,10,116,0.06
Panruti,12,NAGAMANI.M,Independent,45,0,45,0.02
Panruti,13,PRAKASH.R,Independent,125,0,125,0.06
Panruti,14,VELMURUGAN.K,Independent,418,0,418,0.21
Panruti,15,VELMURUGAN.R,Independent,152,0,152,0.08
Panruti,16,NOTA,None of the Above,1320,3,1323,0.67
Papanasam,1,"GOPINATHAN, K.",All India Anna Dravida Munnetra Kazhagam,69809,485,70294,35.69
Papanasam,2,"Dr.JAWAHIRULLAH, M.H.",Dravida Munnetra Kazhagam,85401,1166,86567,43.95
Papanasam,3,"KRISHNAKUMAR, N.",Naam Tamilar Katchi,14645,79,14724,7.47
Papanasam,4,"SHANTHA, K.",Makkal Needhi Maiam,2010,22,2032,1.03
Papanasam,5,"MUTHUKUMAR, R.",Anaithu Makkal Puratchi Katchi,251,1,252,0.13
Papanasam,6,"MEHRAJ BANU, N.",All India Jananayaka Makkal Kazhagam,166,3,169,0.09
Papanasam,7,"RENGASAMY, M.",Amma Makkal Munnettra Kazagam,19593,185,19778,10.04
Papanasam,8,"GOPI, N.",Independent,200,11,211,0.11
Papanasam,9,"GOPINATHAN, R.",Independent,559,8,567,0.29
Papanasam,10,"XAVIER, S.",Independent,159,4,163,0.08
Papanasam,11,"THIYAGARAJAN, V.",Independent,130,2,132,0.07
Papanasam,12,"RAJA, A.",Independent,474,3,477,0.24
Papanasam,13,"RAJA, A.M.",Independent,411,1,412,0.21
Papanasam,14,NOTA,None of the Above,1190,14,1204,0.61
Pappireddipatti,1,GOPI.K,Bahujan Samaj Party,623,2,625,0.28
Pappireddipatti,2,GOVINDASAMY.A,All India Anna Dravida Munnetra Kazhagam,113397,1110,114507,51.81
Pappireddipatti,3,PRABHURAJASEKAR.M,Dravida Munnetra Kazhagam,75831,1733,77564,35.1
Pappireddipatti,4,SRINIVASAN,Makkal Needhi Maiam,1720,9,1729,0.78
Pappireddipatti,5,PALANIAPPAN.P,Amma Makkal Munnettra Kazagam,15597,266,15863,7.18
Pappireddipatti,6,MURUGAN.R,Anaithu Makkal Puratchi Katchi,149,1,150,0.07
Pappireddipatti,7,RAMESH.R,Naam Tamilar Katchi,7490,83,7573,3.43
Pappireddipatti,8,ANAND KUMAR.K,Independent,186,1,187,0.08
Pappireddipatti,9,ELANGO.S,Independent,130,0,130,0.06
Pappireddipatti,10,GOVINDASAMY.R,Independent,426,6,432,0.2
Pappireddipatti,11,SELVAM.P,Independent,89,5,94,0.04
Pappireddipatti,12,PALANIYAPPAN.R,Independent,120,2,122,0.06
Pappireddipatti,13,MANIVANNAN.K,Independent,121,2,123,0.06
Pappireddipatti,14,MURUGAN.S,Independent,299,1,300,0.14
Pappireddipatti,15,VEERAMANI.T,Independent,257,0,257,0.12
Pappireddipatti,16,NOTA,None of the Above,1330,8,1338,0.61
Paramakudi,1,GOVINDAN V,Bahujan Samaj Party,416,9,425,0.23
Paramakudi,2,SADHAN PRABHAKAR N,All India Anna Dravida Munnetra Kazhagam,70488,1091,71579,39.3
Paramakudi,3,SELVI U,Desiya Murpokku Dravida Kazhagam,1988,21,2009,1.1
Paramakudi,4,MURUGESAN S,Dravida Munnetra Kazhagam,83016,1848,84864,46.59
Paramakudi,5,KARUPPU RAJA M,Makkal Needhi Maiam,3447,41,3488,1.91
Paramakudi,6,SASIKALA S,Naam Tamilar Katchi,16262,168,16430,9.02
Paramakudi,7,PARTHASARATHI M,My India Party,187,1,188,0.1
Paramakudi,8,RAMAPANDI C,Independent,184,2,186,0.1
Paramakudi,9,UDHAYAKUMAR M,Independent,208,0,208,0.11
Paramakudi,10,UDAYAKUMAR,Independent,96,0,96,0.05
Paramakudi,11,KUMAR S,Independent,78,1,79,0.04
Paramakudi,12,BALAMURUGAN S,Independent,196,2,198,0.11
Paramakudi,13,MURUKESAN K,Independent,684,3,687,0.38
Paramakudi,14,RAVISANKAR V,Independent,109,0,109,0.06
Paramakudi,15,RAJIV GANDHI K,Independent,350,4,354,0.19
Paramakudi,16,NOTA,None of the Above,1242,16,1258,0.69
Paramathi-Velur,1,RAMAN V,Bahujan Samaj Party,495,0,495,0.27
Paramathi-Velur,2,SEKAR S,All India Anna Dravida Munnetra Kazhagam,84593,1441,86034,46.83
Paramathi-Velur,3,MOORTHIY K S,Dravida Munnetra Kazhagam,76062,2310,78372,42.66
Paramathi-Velur,4,SAMINATHAN P P,Amma Makkal Munnettra Kazagam,1321,8,1329,0.72
Paramathi-Velur,5,SUNDARAM S,United States of India Party,132,4,136,0.07
Paramathi-Velur,6,NATARAJAN K,Makkal Needhi Maiam,1858,24,1882,1.02
Paramathi-Velur,7,MANI K,Ganasangam Party of India,128,4,132,0.07
Paramathi-Velur,8,UVARANI K,Naam Tamilar Katchi,11554,130,11684,6.36
Paramathi-Velur,9,KARTHIKEYAN N,Independent,69,1,70,0.04
Paramathi-Velur,10,KUZHANDAIVEL K,Independent,65,0,65,0.04
Paramathi-Velur,11,SATHISKUMAR D,Independent,66,1,67,0.04
Paramathi-Velur,12,SAMYNATHAN G,Independent,67,1,68,0.04
Paramathi-Velur,13,SEERANGAN P,Independent,155,1,156,0.08
Paramathi-Velur,14,SUNDARAM N,Independent,280,0,280,0.15
Paramathi-Velur,15,SEKAR N,Independent,269,1,270,0.15
Paramathi-Velur,16,SEKAR R,Independent,367,1,368,0.2
Paramathi-Velur,17,THANGARASU M,Independent,177,1,178,0.1
Paramathi-Velur,18,DEVANDRAN G,Independent,259,0,259,0.14
Paramathi-Velur,19,NALLAPPAN K,Independent,219,0,219,0.12
Paramathi-Velur,20,PAPATHI R,Independent,232,0,232,0.13
Paramathi-Velur,21,PARTHASARATHY S,Independent,88,0,88,0.05
Paramathi-Velur,22,BALASUBRAMANIAN A,Independent,21,0,21,0.01
Paramathi-Velur,23,BALAJI R,Independent,33,2,35,0.02
Paramathi-Velur,24,PRABHAHARAN M,Independent,41,1,42,0.02
Paramathi-Velur,25,PERIASAMY R,Independent,52,0,52,0.03
Paramathi-Velur,26,MOORTHY M,Independent,86,1,87,0.05
Paramathi-Velur,27,JAYAKUMAR K,Independent,112,0,112,0.06
Paramathi-Velur,28,NOTA,None of the Above,952,12,964,0.52
Pattukkottai,1,"ANNADURAI, K.",Dravida Munnetra Kazhagam,78060,1005,79065,44.62
Pattukkottai,2,"RENGARAJAN, N.R.",All India Anna Dravida Munnetra Kazhagam,53521,275,53796,30.36
Pattukkottai,3,KEERTHIKA ANBU,Naam Tamilar Katchi,10694,36,10730,6.06
Pattukkottai,4,"SADASIVAM, B.",Makkal Needhi Maiam,3070,18,3088,1.74
Pattukkottai,5,"SUNDARRAJ, M.",Anaithu Makkal Puratchi Katchi,178,1,179,0.1
Pattukkottai,6,"SELVAM, S.D.S.",Amma Makkal Munnettra Kazagam,5191,32,5223,2.95
Pattukkottai,7,"MEIKKAPPAN, T.",Anna Dravidar Kazhagam,322,0,322,0.18
Pattukkottai,8,"BALAKRISHNAN, V.",Independent,23704,67,23771,13.41
Pattukkottai,9,NOTA,None of the Above,1019,7,1026,0.58
Pennagaram,1,INBASEKARAN. P.N.P,Dravida Munnetra Kazhagam,83765,1172,84937,40.39
Pennagaram,2,UTHAYAKUMAR. R,Desiya Murpokku Dravida Kazhagam,2910,11,2921,1.39
Pennagaram,3,MOORTHI. S,Bahujan Samaj Party,238,7,245,0.12
Pennagaram,4,ANNADURAI. C,Desiya Makkal Sakthi Katchi,208,3,211,0.1
Pennagaram,5,TAMILAZHAGAN. R,Naam Tamilar Katchi,8890,55,8945,4.25
Pennagaram,6,MANI. G.K,Pattali Makkal Katchi,105250,873,106123,50.46
Pennagaram,7,SHAKILA. K,Makkal Needhi Maiam,1451,20,1471,0.7
Pennagaram,8,ANNADURAI. V,Independent,207,0,207,0.1
Pennagaram,9,SIVALINGAM. N,Independent,139,3,142,0.07
Pennagaram,10,DHARUMAN. K,Independent,242,1,243,0.12
Pennagaram,11,THIRUMURUGAN. P,Independent,450,1,451,0.21
Pennagaram,12,PERIYANANJAPPAN. A,Independent,1959,9,1968,0.94
Pennagaram,13,MANI. K.G.,Independent,211,1,212,0.1
Pennagaram,14,MANI. P,Independent,202,3,205,0.1
Pennagaram,15,MUNUSAMY. S,Independent,263,2,265,0.13
Pennagaram,16,NOTA,None of the Above,1754,5,1759,0.84
Perambalur,1,"RAJENDRAN, K.",Bahujan Samaj Party,519,1,520,0.22
Perambalur,2,"GUNASEKARAN, A.",Nationalist Congress Party,405,4,409,0.17
Perambalur,3,"THAMIZHSELVAN, R.",All India Anna Dravida Munnetra Kazhagam,90325,731,91056,37.94
Perambalur,4,"PRABHAHARAN, M.",Dravida Munnetra Kazhagam,119636,2454,122090,50.87
Perambalur,5,"RAJENDRAN, K.",Desiya Murpokku Dravida Kazhagam,2918,14,2932,1.22
Perambalur,6,"SASIKALA, M.",Indiya Jananayaka Katchi,1073,7,1080,0.45
Perambalur,7,"MAHESHWARI, M.",Naam Tamilar Katchi,18592,81,18673,7.78
Perambalur,8,"RADHIKA, T.",Puthiya Tamilagam,994,9,1003,0.42
Perambalur,9,"SATHISH, S.",Independent,379,0,379,0.16
Perambalur,10,NOTA,None of the Above,1867,17,1884,0.78
Perambur,1,SURESH. C,Bahujan Samaj Party,515,0,515,0.26
Perambur,2,SHEKAR. R.D,Dravida Munnetra Kazhagam,104580,687,105267,52.53
Perambur,3,DHANAPALAN N.R,All India Anna Dravida Munnetra Kazhagam,50093,198,50291,25.1
Perambur,4,SOOSAI. M.A,Republican Party of India (Athawale),296,0,296,0.15
Perambur,5,SEBASTIN. J,SOCIALIST UNITY CENTRE OF INDIA (COMMUNIST),194,0,194,0.1
Perambur,6,PONNUSAMY. A,Makkal Needhi Maiam,17026,46,17072,8.52
Perambur,7,MERLIN SUGANTHI. S,Naam Tamilar Katchi,19787,34,19821,9.89
Perambur,8,LAKSHMI NARAYANAN. E,Amma Makkal Munnettra Kazagam,4039,3,4042,2.02
Perambur,9,UDAYAKUMAR. S,Independent,59,1,60,0.03
Perambur,10,KADHIRAVAN. M,Independent,48,0,48,0.02
Perambur,11,SATHISHKUMAR. S,Independent,106,0,106,0.05
Perambur,12,SATHEESH. J,Independent,174,0,174,0.09
Perambur,13,SARAVANA PERUMAL. R,Independent,65,0,65,0.03
Perambur,14,SELVARAJ. R,Independent,86,1,87,0.04
Perambur,15,SEKAR. P,Independent,166,0,166,0.08
Perambur,16,PARTHIPAN. P,Independent,172,0,172,0.09
Perambur,17,PREM ANAND. J,Independent,112,0,112,0.06
Perambur,18,RAJESH. K,Independent,163,0,163,0.08
Perambur,19,RAJESH KUMAR. S,Independent,90,0,90,0.04
Perambur,20,VASANTHA KUMAR. M,Independent,40,0,40,0.02
Perambur,21,VINOTHKUMAR. G,Independent,45,0,45,0.02
Perambur,22,VENKATESH. L,Independent,46,0,46,0.02
Perambur,23,NOTA,None of the Above,1508,7,1515,0.76
Peravurani,1,"ASHOKKUMAR, N.",Dravida Munnetra Kazhagam,88102,1028,89130,52.17
Peravurani,2,"SIVAKUMAR, M.",Desiya Murpokku Dravida Kazhagam,1618,5,1623,0.95
Peravurani,3,"THIRUGNANASAMBANDAM, S.V.",All India Anna Dravida Munnetra Kazhagam,65395,232,65627,38.41
Peravurani,4,"DURAIRAJ, G.",Bahujan Samaj Party,493,1,494,0.29
Peravurani,5,"DELIPAN, K.",Naam Tamilar Katchi,12109,45,12154,7.11
Peravurani,6,"PACHAMUTHU, P.",Indiya Jananayaka Katchi,552,2,554,0.32
Peravurani,7,"ELANGOVAN, G.",Independent,236,0,236,0.14
Peravurani,8,"UTHAYAKUMAR, U.",Independent,260,2,262,0.15
Peravurani,9,NOTA,None of the Above,768,2,770,0.45
Periyakulam,1,K.S.SARAVANAKUMAAR,Dravida Munnetra Kazhagam,90360,1891,92251,45.71
Periyakulam,2,M Murugan,All India Anna Dravida Munnetra Kazhagam,70444,486,70930,35.15
Periyakulam,3,Dr.K.Kathirkamu,Amma Makkal Munnettra Kazagam,16317,107,16424,8.14
Periyakulam,4,S.Chinnamuthu,My India Party,299,2,301,0.15
Periyakulam,5,S.PANDIYARAJAN,Makkal Needhi Maiam,5626,54,5680,2.81
Periyakulam,6,A.Murugesan,SOCIALIST UNITY CENTRE OF INDIA (COMMUNIST),201,1,202,0.1
Periyakulam,7,Vimala,Naam Tamilar Katchi,11660,134,11794,5.84
Periyakulam,8,MADHU BHARATHI,Independent,622,6,628,0.31
Periyakulam,9,C.MAYAZHAKU,Independent,56,1,57,0.03
Periyakulam,10,MURUGAN,Independent,335,4,339,0.17
Periyakulam,11,M.Muniyappan,Independent,94,0,94,0.05
Periyakulam,12,M.Muneeswaran,Independent,143,0,143,0.07
Periyakulam,13,"A.C.MOHAN RAJ B.P.T.,",Independent,148,1,149,0.07
Periyakulam,14,P.RAMAIYA,Independent,112,0,112,0.06
Periyakulam,15,M.RAJENDRAN,Independent,237,5,242,0.12
Periyakulam,16,NOTA,None of the Above,2414,37,2451,1.21
Perundurai,1,"KULANDAIVEL, P. R.",Desiya Murpokku Dravida Kazhagam,857,1,858,0.45
Perundurai,2,KKC BALU,Dravida Munnetra Kazhagam,69569,1049,70618,37.2
Perundurai,3,"THAMBI, M.",Bahujan Samaj Party,1612,8,1620,0.85
Perundurai,4,"JAYAKUMAR, S.",All India Anna Dravida Munnetra Kazhagam,84532,593,85125,44.84
Perundurai,5,"DHAKSHINAMURTHI, K. S.",Desiya Makkal Sakthi Katchi,617,1,618,0.33
Perundurai,6,"NANDHAKUMAR, C. K.",Makkal Needhi Maiam,3506,27,3533,1.86
Perundurai,7,"PRABAKARAN, D.",All India Jananayaka Makkal Kazhagam,102,0,102,0.05
Perundurai,8,"RAMESH, M.",Namathu Kongu Munnetra Kalagam,89,1,90,0.05
Perundurai,9,"LOGANATHAN, C.",Naam Tamilar Katchi,10243,51,10294,5.42
Perundurai,10,"VELUSAMY, P.",Anna Puratchi Thalaivar Amma Dravida Munnetra Kazhagam,107,0,107,0.06
Perundurai,11,"KARTHI, M.",Independent,169,0,169,0.09
Perundurai,12,"KRISHNAN, S.",Independent,79,0,79,0.04
Perundurai,13,"GOPALAKRISHNAN, J.",Independent,182,0,182,0.1
Perundurai,14,SHANKARSAMY,Independent,3328,8,3336,1.76
Perundurai,15,"SATHISHKUMAR, N.",Independent,799,0,799,0.42
Perundurai,16,"SAMPATH KUMAR, K.",Independent,245,0,245,0.13
Perundurai,17,"DEVENDARAMANICKAM, S. R.",Independent,176,4,180,0.09
Perundurai,18,THOPPU VENKATACHALAM (A) N.D .VENKATACHALAM,Independent,9815,80,9895,5.21
Perundurai,19,"BALASUBRAMANI, V. M.",Independent,128,0,128,0.07
Perundurai,20,"BALAMURUGAN, M.",Independent,129,0,129,0.07
Perundurai,21,"MYILSAMY, M.",Independent,85,1,86,0.05
Perundurai,22,"VENKATACHALAM, K.",Independent,59,1,60,0.03
Perundurai,23,"VENKADACHALAM, P. R.",Independent,219,2,221,0.12
Perundurai,24,"JEEVA, N.",Independent,74,0,74,0.04
Perundurai,25,"JOTHIMURUGAN, P.",Independent,106,0,106,0.06
Perundurai,26,NOTA,None of the Above,1179,10,1189,0.63
Pollachi,1,"Aruchamy, C.M.",Bahujan Samaj Party,488,3,491,0.28
Pollachi,2,Pollachi V. Jayaraman,All India Anna Dravida Munnetra Kazhagam,79906,661,80567,45.44
Pollachi,3,"Dr. Varadharajan, K.",Dravida Munnetra Kazhagam,77882,960,78842,44.47
Pollachi,4,"Sathieshkumar, V.T.",Makkal Needhi Maiam,7548,41,7589,4.28
Pollachi,5,"Sugumar, K.",Amma Makkal Munnettra Kazagam,1135,6,1141,0.64
Pollachi,6,"Logeswari, N.",Naam Tamilar Katchi,6375,27,6402,3.61
Pollachi,7,"Shanthu Mohamed, A.",Independent,368,0,368,0.21
Pollachi,8,"Muthukumarasamy, R.",Independent,361,1,362,0.2
Pollachi,9,NOTA,None of the Above,1533,13,1546,0.87
Polur,1,Ezhilarasu. M,Bahujan Samaj Party,600,4,604,0.3
Polur,2,Agri KRISHNAMURTHY. S S,All India Anna Dravida Munnetra Kazhagam,96878,854,97732,48.38
Polur,3,SEKARAN. K.V,Dravida Munnetra Kazhagam,86544,1463,88007,43.57
Polur,4,KALAVATHI. G,Makkal Needhi Maiam,1561,19,1580,0.78
Polur,5,LAVANYA. L,Naam Tamilar Katchi,10065,132,10197,5.05
Polur,6,VIJAYAKUMAR. C,Amma Makkal Munnettra Kazagam,646,10,656,0.32
Polur,7,GANESAN. C,Independent,55,0,55,0.03
Polur,8,KALAIMANI. S,Independent,56,0,56,0.03
Polur,9,KRISHNAMURTHI. K,Independent,50,0,50,0.02
Polur,10,Shanmugasundaram. E,Independent,82,8,90,0.04
Polur,11,SATHIYARAJ. P,Independent,77,10,87,0.04
Polur,12,CHIDAMBARAM. V,Independent,71,1,72,0.04
Polur,13,SIVA. A,Independent,216,0,216,0.11
Polur,14,DAKSNAMOORTHY. R,Independent,1188,0,1188,0.59
Polur,15,MURUGESAN. D,Independent,278,0,278,0.14
Polur,16,NOTA,None of the Above,1131,13,1144,0.57
Ponneri,1,DURAI. CHANDRASEKAR,Indian National Congress,93669,859,94528,44.94
Ponneri,2,BALARAMAN. P,All India Anna Dravida Munnetra Kazhagam,84534,305,84839,40.33
Ponneri,3,BHAVANI ILAVENIL. J,Bahujan Samaj Party,1102,4,1106,0.53
Ponneri,4,DESINGURAJAN. D,Makkal Needhi Maiam,5372,22,5394,2.56
Ponneri,5,MAHESWARI. A,Naam Tamilar Katchi,18973,54,19027,9.05
Ponneri,6,PON. RAJA,Amma Makkal Munnettra Kazagam,2813,19,2832,1.35
Ponneri,7,VIJAYAKUMAR. V,Anna MGR Dravida Makkal Kalgam,189,1,190,0.09
Ponneri,8,ASHOK PRIYADARSHAN. S,Independent,470,0,470,0.22
Ponneri,9,SAMBATH KUMAR.C.H,Independent,116,0,116,0.06
Ponneri,10,SUGUMAR. K,Independent,298,0,298,0.14
Ponneri,11,NOTA,None of the Above,1551,3,1554,0.74
Poompuhar,1,T. Ilanchezhian,Bahujan Samaj Party,496,4,500,0.24
Poompuhar,2,S.Pavunraj,All India Anna Dravida Munnetra Kazhagam,92299,504,92803,44.65
Poompuhar,3,Nivedha M. Murugan,Dravida Munnetra Kazhagam,95161,941,96102,46.24
Poompuhar,4,P. Kaliyammal,Naam Tamilar Katchi,14783,40,14823,7.13
Poompuhar,5,S.Senthamizhan,Amma Makkal Munnettra Kazagam,1212,8,1220,0.59
Poompuhar,6,M.H.Meharajdeen,Makkal Needhi Maiam,946,4,950,0.46
Poompuhar,7,A. Kalaivanan,Independent,102,0,102,0.05
Poompuhar,8,S.Pandiyarajan,Independent,343,0,343,0.17
Poompuhar,9,S.Murugan,Independent,261,1,262,0.13
Poompuhar,10,NOTA,None of the Above,727,6,733,0.35
Poonamallee,1,Krishnaswamy A,Dravida Munnetra Kazhagam,148383,1195,149578,56.72
Poonamallee,2,Sathyamurthy A C,Bahujan Samaj Party,2880,11,2891,1.1
Poonamallee,3,Rajamannar S X,Pattali Makkal Katchi,55249,219,55468,21.03
Poonamallee,4,Elumalai T.A.,Amma Makkal Munnettra Kazagam,8771,34,8805,3.34
Poonamallee,5,Boshya Gayathri M,My India Party,288,2,290,0.11
Poonamallee,6,Manimekalai A,Naam Tamilar Katchi,29804,67,29871,11.33
Poonamallee,7,Revathi Manimegalai J,Makkal Needhi Maiam,11877,50,11927,4.52
Poonamallee,8,Sivakumar S,Independent,403,0,403,0.15
Poonamallee,9,Dhasarathan R,Independent,173,0,173,0.07
Poonamallee,10,Purushothaman B,Independent,173,2,175,0.07
Poonamallee,11,Ravikumar M,Independent,448,0,448,0.17
Poonamallee,12,Rajesh P,Independent,241,0,241,0.09
Poonamallee,13,Venkatesan J,Independent,240,0,240,0.09
Poonamallee,14,Velu S,Independent,359,0,359,0.14
Poonamallee,15,NOTA,None of the Above,2849,18,2867,1.09
Pudukkottai,1,KARTHIK THONDAIMAN,All India Anna Dravida Munnetra Kazhagam,72247,554,72801,40.47
Pudukkottai,2,M . SUBRAMANIAN,Desiya Murpokku Dravida Kazhagam,1857,16,1873,1.04
Pudukkottai,3,V . MUTHURAJA,Dravida Munnetra Kazhagam,83792,2010,85802,47.7
Pudukkottai,4,VENGADESHWARAN,Bahujan Samaj Party,456,7,463,0.26
Pudukkottai,5,KUMAR,My India Party,95,0,95,0.05
Pudukkottai,6,SASIKUMAR,Naam Tamilar Katchi,11411,92,11503,6.39
Pudukkottai,7,M. SARAVANA DEVA,Namadhu Makkal Katchi,416,8,424,0.24
Pudukkottai,8,S . MOORTHY,Makkal Needhi Maiam,3920,28,3948,2.19
Pudukkottai,9,I . ABDULLAH,Independent,41,0,41,0.02
Pudukkottai,10,KARUPPAIAH . C,Independent,103,1,104,0.06
Pudukkottai,11,S . KARTHIKEYAN,Independent,58,0,58,0.03
Pudukkottai,12,KARTHIKEYAN,Independent,388,5,393,0.22
Pudukkottai,13,S . SAHUL AMEEDU,Independent,88,1,89,0.05
Pudukkottai,14,S . SOUNDAR RAJA,Independent,204,1,205,0.11
Pudukkottai,15,K . DHANAGOPAL,Independent,180,0,180,0.1
Pudukkottai,16,DURAI GUNA,Independent,475,1,476,0.26
Pudukkottai,17,V. N. MUTHUKUMAR,Independent,380,0,380,0.21
Pudukkottai,18,M . RAJINIKANTH,Independent,90,0,90,0.05
Pudukkottai,19,A. RAJASEKAR,Independent,250,0,250,0.14
Pudukkottai,20,P. VIJAYAKUMAR,Independent,71,0,71,0.04
Pudukkottai,21,N. VEERIAH,Independent,42,0,42,0.02
Pudukkottai,22,NOTA,None of the Above,596,8,604,0.34
Radhapuram,1,M.Appavu,Dravida Munnetra Kazhagam,80241,2090,82331,43.95
Radhapuram,2,E.Esakkiammal,Bahujan Samaj Party,460,4,464,0.25
Radhapuram,3,I.S.Inbadurai,All India Anna Dravida Munnetra Kazhagam,75749,657,76406,40.79
Radhapuram,4,K.Jeyabalan,Desiya Murpokku Dravida Kazhagam,2409,23,2432,1.3
Radhapuram,5,N.Godfrey Washington Noble,Aanaithinthiya Jananayaka Pathukappu Kazhagam,235,0,235,0.13
Radhapuram,6,M.Chandran,Veerath Thiyagi Viswanathadoss Thozhilalarkal Katchi,291,4,295,0.16
Radhapuram,7,J.Jesu Rajendran,Naam Indiar Party,328,1,329,0.18
Radhapuram,8,R.Jesu Dhasan,Naam Tamilar Katchi,19271,100,19371,10.34
Radhapuram,9,M.Antony Rossary,Independent,98,0,98,0.05
Radhapuram,10,S.Abinanth Ram,Independent,68,1,69,0.04
Radhapuram,11,D.Arunraj,Independent,139,0,139,0.07
Radhapuram,12,S.Katteri Perumal,Independent,59,0,59,0.03
Radhapuram,13,N.Kannan,Independent,191,2,193,0.1
Radhapuram,14,A.Kumar,Independent,309,9,318,0.17
Radhapuram,15,M.Saswathan,Independent,116,1,117,0.06
Radhapuram,16,R.Sudalaimani,Independent,466,4,470,0.25
Radhapuram,17,K.Subburaj,Independent,518,0,518,0.28
Radhapuram,18,D.Sheik Syed Ali,Independent,95,0,95,0.05
Radhapuram,19,T.Sermadurai,Independent,455,1,456,0.24
Radhapuram,20,G.Deva Peran,Independent,1221,3,1224,0.65
Radhapuram,21,S.Manikandan,Independent,52,0,52,0.03
Radhapuram,22,T.Muthu Selvi,Independent,308,2,310,0.17
Radhapuram,23,T.Rethina Pandi,Independent,59,0,59,0.03
Radhapuram,24,M.Vijayakumar,Independent,143,0,143,0.08
Radhapuram,25,T.Venus Veera Arasu,Independent,222,2,224,0.12
Radhapuram,26,NOTA,None of the Above,894,9,903,0.48
Rajapalayam,1,THANGAPANDIAN S.,Dravida Munnetra Kazhagam,72712,1446,74158,41.5
Rajapalayam,2,RAJENTHRABHALAJI K.T,All India Anna Dravida Munnetra Kazhagam,69870,390,70260,39.32
Rajapalayam,3,AYYAR V.K.,Puthiya Tamilagam,3348,40,3388,1.9
Rajapalayam,4,KALIMUTHU K.,Amma Makkal Munnettra Kazagam,7607,53,7660,4.29
Rajapalayam,5,DHARMALINGAM K.,Republican Party of India (Athawale),106,3,109,0.06
Rajapalayam,6,VIVEKANANTHAN S.,Makkal Needhi Maiam,4023,36,4059,2.27
Rajapalayam,7,JEYARAJ V.,Naam Tamilar Katchi,15448,145,15593,8.73
Rajapalayam,8,KALIMUTHU K.,Independent,120,0,120,0.07
Rajapalayam,9,SELVARAJ G.,Independent,84,2,86,0.05
Rajapalayam,10,THANGAPANDI B.,Independent,111,1,112,0.06
Rajapalayam,11,THANGAPANDI S.,Independent,261,3,264,0.15
Rajapalayam,12,MANIKUMAR M.,Independent,546,2,548,0.31
Rajapalayam,13,VIJAYAKUMAR E.,Independent,140,0,140,0.08
Rajapalayam,14,JEYAPRAKASH I.,Independent,335,1,336,0.19
Rajapalayam,15,NOTA,None of the Above,1869,6,1875,1.05
Ramanathapuram,1,ALLAPICHAI,Bahujan Samaj Party,634,2,636,0.3
Ramanathapuram,2,KATHARBATCHA MUTHURAMALINGAM,Dravida Munnetra Kazhagam,109712,1370,111082,51.88
Ramanathapuram,3,D.KUPPURAMU,Bharatiya Janata Party,60262,341,60603,28.31
Ramanathapuram,4,AMUTHAN,Namadhu Makkal Katchi,382,1,383,0.18
Ramanathapuram,5,K.ILANGO,Naam Tamilar Katchi,16960,86,17046,7.96
Ramanathapuram,6,K.P SARAVANAN,Makkal Needhi Maiam,1962,23,1985,0.93
Ramanathapuram,7,G.MUNIYASAMY,Amma Makkal Munnettra Kazagam,6710,50,6760,3.16
Ramanathapuram,8,R.S.WILHELM BENJAMIN ANAND,Bahujan Dravida Party,77,1,78,0.04
Ramanathapuram,9,V.JAYAPRAKASH,My India Party,133,0,133,0.06
Ramanathapuram,10,ASANALI,Independent,77,1,78,0.04
Ramanathapuram,11,K.KURUNTHAPPAN,Independent,245,1,246,0.11
Ramanathapuram,12,SALEEM,Independent,125,3,128,0.06
Ramanathapuram,13,S.SURESH,Independent,190,0,190,0.09
Ramanathapuram,14,SURYAPRAKASH,Independent,1000,2,1002,0.47
Ramanathapuram,15,P.MALAICHAMY,Independent,10808,14,10822,5.05
Ramanathapuram,16,MISRA G,Independent,493,2,495,0.23
Ramanathapuram,17,N MUNIYASAMI,Independent,119,0,119,0.06
Ramanathapuram,18,E VINOTH,Independent,1216,0,1216,0.57
Ramanathapuram,19,B VIJAYAPRAKASH,Independent,343,0,343,0.16
Ramanathapuram,20,NOTA,None of the Above,747,6,753,0.35
Ranipet,1,R.GANDHI,Dravida Munnetra Kazhagam,102273,1018,103291,49.79
Ranipet,2,S.M.SUGUMAR,All India Anna Dravida Munnetra Kazhagam,86339,454,86793,41.84
Ranipet,3,A.YUVARAJ,Bahujan Samaj Party,664,5,669,0.32
Ranipet,4,M.ATHAM BASHA,Makkal Needhi Maiam,2746,16,2762,1.33
Ranipet,5,Dr.K.SATHIYARAJ,Tamil Nadu Ilangyar Katchi,273,2,275,0.13
Ranipet,6,V.SHYLAJA,Naam Tamilar Katchi,10152,82,10234,4.93
Ranipet,7,G.VEERAMANI,Amma Makkal Munnettra Kazagam,627,10,637,0.31
Ranipet,8,S.GANDHI,Independent,63,1,64,0.03
Ranipet,9,K.SAKTHIVEL NATHAN,Independent,48,0,48,0.02
Ranipet,10,N.SUGUMAR,Independent,63,0,63,0.03
Ranipet,11,A.MANIKANDAN,Independent,267,1,268,0.13
Ranipet,12,A.MANSUR BASHA,Independent,194,0,194,0.09
Ranipet,13,S.YUVARAJ,Independent,106,1,107,0.05
Ranipet,14,S.JAYAKUMAR,Independent,425,0,425,0.2
Ranipet,15,NOTA,None of the Above,1625,7,1632,0.79
Rasipuram,1,SAROJA V. Dr,All India Anna Dravida Munnetra Kazhagam,87851,924,88775,45.09
Rasipuram,2,MATHIVENTHAN M,Dravida Munnetra Kazhagam,88612,2115,90727,46.08
Rasipuram,3,VIJAYA K,Bahujan Samaj Party,346,5,351,0.18
Rasipuram,4,ARULMOZHIDEVAN P,Tamilaga Makkal Thannurimai Katchi,216,1,217,0.11
Rasipuram,5,ANBALAGAN S,Amma Makkal Munnettra Kazagam,1042,9,1051,0.53
Rasipuram,6,RAMKUMAR R,Indiya Jananayaka Katchi,1119,14,1133,0.58
Rasipuram,7,SILAMBARASI K,Naam Tamilar Katchi,11140,155,11295,5.74
Rasipuram,8,CHINNUSAMY P,Ganasangam Party of India,146,1,147,0.07
Rasipuram,9,JAYANTHI M,Ambedkarite Party of India,140,2,142,0.07
Rasipuram,10,SEERANGAN P,Independent,62,1,63,0.03
Rasipuram,11,PALANIVEL S,Independent,150,1,151,0.08
Rasipuram,12,POONGODI S,Independent,88,0,88,0.04
Rasipuram,13,MANIVANNAN A,Independent,81,0,81,0.04
Rasipuram,14,MADHIYAZHAGAN D,Independent,123,0,123,0.06
Rasipuram,15,MUNIYAPPAN M,Independent,449,1,450,0.23
Rasipuram,16,NOTA,None of the Above,2088,22,2110,1.07
Rishivandiyam,1,KARTHIKEYAN K,Dravida Munnetra Kazhagam,112998,914,113912,52.96
Rishivandiyam,2,SANTHOSH S A,All India Anna Dravida Munnetra Kazhagam,71921,263,72184,33.56
Rishivandiyam,3,VEERAN S,Bahujan Samaj Party,424,2,426,0.2
Rishivandiyam,4,SHANMUGASUNDARAM K,Makkal Needhi Maiam,637,3,640,0.3
Rishivandiyam,5,SURESH MANIVANNAN R,Naam Tamilar Katchi,12041,25,12066,5.61
Rishivandiyam,6,TAMILVANAN M,My India Party,150,1,151,0.07
Rishivandiyam,7,NARAYANAN A,Anna MGR Dravida Makkal Kalgam,141,1,142,0.07
Rishivandiyam,8,PRABHU S,Amma Makkal Munnettra Kazagam,10367,20,10387,4.83
Rishivandiyam,9,RADHAKRISHNAN K,Makkal Munnetra Peravai,127,2,129,0.06
Rishivandiyam,10,VENKATRAMAN J,Naadaalum Makkal Katchi,149,0,149,0.07
Rishivandiyam,11,KARTHIK G,Independent,129,0,129,0.06
Rishivandiyam,12,GURU K,Independent,267,1,268,0.12
Rishivandiyam,13,CHANDRASEKARAN V,Independent,287,0,287,0.13
Rishivandiyam,14,SANTHOSH M,Independent,308,0,308,0.14
Rishivandiyam,15,MURUGAN K,Independent,1508,0,1508,0.7
Rishivandiyam,16,NOTA,None of the Above,2419,1,2420,1.13
Royapuram,1,KUMAR.S,Bahujan Samaj Party,180,0,180,0.15
Royapuram,2,MURTHY.R.IDREAM,Dravida Munnetra Kazhagam,64095,329,64424,53.16
Royapuram,3,JAYAKUMAR.D,All India Anna Dravida Munnetra Kazhagam,36458,187,36645,30.24
Royapuram,4,KAMALI.S,Naam Tamilar Katchi,7923,30,7953,6.56
Royapuram,5,GUNASEKARAN.S,Makkal Needhi Maiam,8139,27,8166,6.74
Royapuram,6,MOHAN.A,Tipu Sultan Party,172,0,172,0.14
Royapuram,7,RAMAJAYAM.C,Amma Makkal Munnettra Kazagam,1124,4,1128,0.93
Royapuram,8,JAMES MARTIN.M,Tamil Nadu Ilangyar Katchi,554,3,557,0.46
Royapuram,9,KARUNAKARAN.H,Independent,26,0,26,0.02
Royapuram,10,KARTHICK.V,Independent,21,0,21,0.02
Royapuram,11,KALIDASS.K.R,Independent,27,0,27,0.02
Royapuram,12,GOKUL.G,Independent,52,0,52,0.04
Royapuram,13,SATHISH.S,Independent,30,0,30,0.02
Royapuram,14,SUGANTHAN.T,Independent,205,0,205,0.17
Royapuram,15,SUNDARAPANDIAN.R,Independent,60,0,60,0.05
Royapuram,16,SUBRAMANI.S.N,Independent,85,0,85,0.07
Royapuram,17,CHELLAPPPAN.T,Independent,50,0,50,0.04
Royapuram,18,SELVAKUMAR.J,Independent,133,0,133,0.11
Royapuram,19,DHANASEKARAN.G,Independent,109,0,109,0.09
Royapuram,20,DINAKARAN.S,Independent,56,0,56,0.05
Royapuram,21,PRASATH.K,Independent,58,0,58,0.05
Royapuram,22,PRABHAKARAN.V,Independent,55,0,55,0.05
Royapuram,23,PRABHU.D,Independent,18,0,18,0.01
Royapuram,24,MURTHY.T.C.S,Independent,42,1,43,0.04
Royapuram,25,VINDHAN.A,Independent,10,0,10,0.01
Royapuram,26,VELU.G,Independent,27,0,27,0.02
Royapuram,27,NOTA,None of the Above,896,5,901,0.74
Saidapet,1,KOTTUR KUMAR. R,Bahujan Samaj Party,274,0,274,0.17
Saidapet,2,SUBRAMANIAN. MA,Dravida Munnetra Kazhagam,79715,479,80194,50.02
Saidapet,3,SAIDAI DURAISAMY,All India Anna Dravida Munnetra Kazhagam,50633,153,50786,31.68
Saidapet,4,SAGAYAMARY. N,Republican Party of India (Athawale),208,1,209,0.13
Saidapet,5,SIVAGNANASAMBANDAN. T,Desiya Makkal Sakthi Katchi,87,2,89,0.06
Saidapet,6,SNEGAPRIYA,Makkal Needhi Maiam,13413,41,13454,8.39
Saidapet,7,SURESH KUMAR. B,Naam Tamilar Katchi,10687,30,10717,6.68
Saidapet,8,SENTHAMIZHAN. G,Amma Makkal Munnettra Kazagam,2076,5,2081,1.3
Saidapet,9,ASHOK KUMAR. V,Independent,38,0,38,0.02
Saidapet,10,ARUN KUMAR. M,Independent,30,0,30,0.02
Saidapet,11,ALAGANATHAN. B,Independent,18,0,18,0.01
Saidapet,12,IMRAN KHAN. M,Independent,47,0,47,0.03
Saidapet,13,ELANGO. K,Independent,22,1,23,0.01
Saidapet,14,KANDHASAMY. R,Independent,141,0,141,0.09
Saidapet,15,KOTHANDAPANI. K,Independent,48,0,48,0.03
Saidapet,16,SATHISH KUMAR. S,Independent,121,0,121,0.08
Saidapet,17,SARAVANAN. D,Independent,91,0,91,0.06
Saidapet,18,SIVASANKAR. S. R,Independent,182,0,182,0.11
Saidapet,19,BALAJI. V,Independent,145,0,145,0.09
Saidapet,20,PRAKASH. C,Independent,20,0,20,0.01
Saidapet,21,PREM KUMAR. A,Independent,40,0,40,0.02
Saidapet,22,MANIMARAN. S,Independent,43,0,43,0.03
Saidapet,23,MURTHI. R,Independent,125,0,125,0.08
Saidapet,24,RAJESH. N,Independent,23,0,23,0.01
Saidapet,25,RISHI KUMAR. A,Independent,31,0,31,0.02
Saidapet,26,LOGANATHAN. J,Independent,34,0,34,0.02
Saidapet,27,VASANTH. H,Independent,30,0,30,0.02
Saidapet,28,VIJAYA KUMAR. R,Independent,37,0,37,0.02
Saidapet,29,VENKATESH. K,Independent,32,0,32,0.02
Saidapet,30,JOTHI SAIRAM. S,Independent,66,0,66,0.04
Saidapet,31,NOTA,None of the Above,1155,3,1158,0.72
Salem (North),1,R. RAJENDRAN,Dravida Munnetra Kazhagam,91222,2210,93432,46.17
Salem (North),2,M.P.PANNEER SELVAM,National People's Party,338,7,345,0.17
Salem (North),3,G.VENKATACHALAM,All India Anna Dravida Munnetra Kazhagam,85026,818,85844,42.42
Salem (North),4,S VELAN,Bahujan Samaj Party,299,1,300,0.15
Salem (North),5,M AHAMEDSHAHJAHAN,MGR Makkal Katchi,95,1,96,0.05
Salem (North),6,IMAYAESWARAN N,Naam Tamilar Katchi,8079,76,8155,4.03
Salem (North),7,R S GURU CHAKRAVARTHY,Makkal Needhi Maiam,10610,108,10718,5.3
Salem (North),8,C NATARAJAN,Amma Makkal Munnettra Kazagam,800,5,805,0.4
Salem (North),9,S. BABU,My India Party,39,0,39,0.02
Salem (North),10,D.MURALI,Dhesiya Makkal Kazhagam,24,1,25,0.01
Salem (North),11,VAATHIAR C MURUGAN,Ambedkarite Party of India,54,1,55,0.03
Salem (North),12,M.SHANMUGA SUNDARAM,Independent,69,4,73,0.04
Salem (North),13,R SENTHILKUMAR,Independent,62,1,63,0.03
Salem (North),14,N DEVARAJ,Independent,165,2,167,0.08
Salem (North),15,M.R.NAWAZUDIEEN,Independent,50,0,50,0.02
Salem (North),16,R PALANISAMY,Independent,208,0,208,0.1
Salem (North),17,A RAMESHKUMAR,Independent,213,0,213,0.11
Salem (North),18,P.RAMACHANDRAN,Independent,27,0,27,0.01
Salem (North),19,S RAJASEKAR,Independent,177,0,177,0.09
Salem (North),20,T.VIJAYA RAJ,Independent,44,1,45,0.02
Salem (North),21,NOTA,None of the Above,1505,34,1539,0.76
Salem (South),1,A.S.SARAVANAN,Dravida Munnetra Kazhagam,73694,1203,74897,37.45
Salem (South),2,E.BALASUBRAMANIAN,All India Anna Dravida Munnetra Kazhagam,96787,719,97506,48.76
Salem (South),3,S.MURALI,Bahujan Samaj Party,397,3,400,0.2
Salem (South),4,R.ELAVARASAN,Veerath Thiyagi Viswanathadoss Thozhilalarkal Katchi,74,1,75,0.04
Salem (South),5,SATHIYAPRIYA,Republican Party of India (Athawale),78,1,79,0.04
Salem (South),6,M.SUNDAR,Ambedkarite Party of India,86,1,87,0.04
Salem (South),7,M.PRABU MANIKANDAN,Makkal Needhi Maiam,10308,60,10368,5.18
Salem (South),8,S.MARIAMMA,Naam Tamilar Katchi,10128,48,10176,5.09
Salem (South),9,S.RAJI,Dhesiya Makkal Kazhagam,60,1,61,0.03
Salem (South),10,SE.VENKATAJALAM,Amma Makkal Munnettra Kazagam,2952,18,2970,1.49
Salem (South),11,R.VELMURUGAN,Communist Party of India  (Marxist-Leninist)  (Liberation),130,3,133,0.07
Salem (South),12,S.KRISHNAKUMAR,Independent,45,1,46,0.02
Salem (South),13,M.KUMAR,Independent,61,1,62,0.03
Salem (South),14,S.SARAVANAN,Independent,61,2,63,0.03
Salem (South),15,SAMUNDESWARI.V,Independent,148,1,149,0.07
Salem (South),16,R.SUNDARAM,Independent,311,0,311,0.16
Salem (South),17,K.SELVARAJ,Independent,210,0,210,0.11
Salem (South),18,B.DEVI,Independent,224,0,224,0.11
Salem (South),19,M.PERIYASAMY,Independent,61,0,61,0.03
Salem (South),20,N.MAYAKANNAN,Independent,58,0,58,0.03
Salem (South),21,K.MARIAPPAN,Independent,22,0,22,0.01
Salem (South),22,D.M.MOHAMMAD NAZEERUDEEN,Independent,25,1,26,0.01
Salem (South),23,K.YASIN BASHA,Independent,26,0,26,0.01
Salem (South),24,K.N.VEERASENAN,Independent,111,1,112,0.06
Salem (South),25,NOTA,None of the Above,1832,28,1860,0.93
Salem (West),1,ALAGAAPURAM R. MOHANRAJ,Desiya Murpokku Dravida Kazhagam,2280,27,2307,1.06
Salem (West),2,TAMIL SELVAN. S,Bahujan Samaj Party,277,6,283,0.13
Salem (West),3,RAJENDRAN. A,Dravida Munnetra Kazhagam,82389,1595,83984,38.77
Salem (West),4,ARUL. R,Pattali Makkal Katchi,104728,755,105483,48.69
Salem (West),5,KATHIRVEL. A,My India Party,329,1,330,0.15
Salem (West),6,KARTHIKEYAN. J,Tamil Nadu Ilangyar Katchi,576,4,580,0.27
Salem (West),7,SENTHILKUMAR. A,Anaithu Makkal Puratchi Katchi,97,2,99,0.05
Salem (West),8,THIYAGARAJAN. A,Makkal Needhi Maiam,7867,72,7939,3.66
Salem (West),9,NAGAMMAL. S,Naam Tamilar Katchi,10592,76,10668,4.92
Salem (West),10,MUTHUSAMY. R,Tamilaga Makkal Thannurimai Katchi,156,8,164,0.08
Salem (West),11,VIJAYAKUMAR. R,Dhesiya Makkal Kazhagam,637,2,639,0.29
Salem (West),12,INBARAJ. A,Independent,108,2,110,0.05
Salem (West),13,KATHAVARAYAN. S,Independent,230,2,232,0.11
Salem (West),14,GOPI. M,Independent,211,0,211,0.1
Salem (West),15,GOPINATH. R,Independent,68,0,68,0.03
Salem (West),16,CHANDRASEKARAN. G,Independent,191,0,191,0.09
Salem (West),17,SABBAPATHI. M,Independent,93,0,93,0.04
Salem (West),18,SARATHKUMAR. S,Independent,240,1,241,0.11
Salem (West),19,SIVARAMAN. S,Independent,221,1,222,0.1
Salem (West),20,THIYAGARAJAN. M,Independent,315,0,315,0.15
Salem (West),21,NATARAJAN. C,Independent,105,0,105,0.05
Salem (West),22,BALAJI. D,Independent,36,0,36,0.02
Salem (West),23,MAYAKANNAN. M,Independent,57,0,57,0.03
Salem (West),24,MARIMUTHU. M,Independent,120,0,120,0.06
Salem (West),25,MURUGAN. A,Independent,78,1,79,0.04
Salem (West),26,RAMKUMAR. R,Independent,128,0,128,0.06
Salem (West),27,RAJENDIRAN. B,Independent,132,0,132,0.06
Salem (West),28,JEEVANANTHAM. M,Independent,128,1,129,0.06
Salem (West),29,NOTA,None of the Above,1663,20,1683,0.78
Sankarankovil,1,RAJALAKSHMI V M,All India Anna Dravida Munnetra Kazhagam,65677,373,66050,36.03
Sankarankovil,2,RAJA E,Dravida Munnetra Kazhagam,70144,1203,71347,38.92
Sankarankovil,3,ANNADURAI R,Amma Makkal Munnettra Kazagam,22278,404,22682,12.37
Sankarankovil,4,SUBRAMANIAM V,Puthiya Tamilagam,1912,29,1941,1.06
Sankarankovil,5,PANEERSELVAM U,Tamizhaga Murpokku Makkal Katchi,186,1,187,0.1
Sankarankovil,6,BALAMURUGESAN M,Bahujan Dravida Party,94,3,97,0.05
Sankarankovil,7,PRABHU K,Makkal Needhi Maiam,2319,19,2338,1.28
Sankarankovil,8,MAHENDRAKUMARI P,Naam Tamilar Katchi,13683,168,13851,7.55
Sankarankovil,9,MATHANKUMAR K,My India Party,168,3,171,0.09
Sankarankovil,10,GANESAN A,Independent,106,1,107,0.06
Sankarankovil,11,KARUTHAPANDIYAN R,Independent,408,0,408,0.22
Sankarankovil,12,GURURAJ P,Independent,303,0,303,0.17
Sankarankovil,13,MUTHUKKUTTI S,Independent,389,0,389,0.21
Sankarankovil,14,VALLIAMMAL M,Independent,888,2,890,0.49
Sankarankovil,15,VETRIMARAN A,Independent,620,0,620,0.34
Sankarankovil,16,NOTA,None of the Above,1937,20,1957,1.07
Sankarapuram,1,UDHAYASURIYAN T,Dravida Munnetra Kazhagam,119487,1699,121186,56.16
Sankarapuram,2,Sakthivel S,Bahujan Samaj Party,807,3,810,0.38
Sankarapuram,3,ARUNKENNADI A P,All  India  Pattali  Munnetra Katchi,203,0,203,0.09
Sankarapuram,4,OVIYAR ANANDH C,Lok Jan Shakti Party,256,1,257,0.12
Sankarapuram,5,MUJIBUR RAGIMAN M,All India Majlis-E-Ittehadul Muslimeen,377,2,379,0.18
Sankarapuram,6,RAMESH G,Indiya Jananayaka Katchi,458,2,460,0.21
Sankarapuram,7,RAJIYAMA B,Naam Tamilar Katchi,9824,49,9873,4.58
Sankarapuram,8,Dr.RAJA G,Pattali Makkal Katchi,74702,521,75223,34.86
Sankarapuram,9,VIMALAMARY S,Anna MGR Dravida Makkal Kalgam,603,6,609,0.28
Sankarapuram,10,ARUL P,Independent,2119,1,2120,0.98
Sankarapuram,11,UTHAYAKUMAR A,Independent,165,1,166,0.08
Sankarapuram,12,KUBENDIRAN A,Independent,428,0,428,0.2
Sankarapuram,13,GOPINATH E,Independent,272,0,272,0.13
Sankarapuram,14,DHANAM K,Independent,348,0,348,0.16
Sankarapuram,15,BABUGANESH S,Independent,292,1,293,0.14
Sankarapuram,16,MANNAN M P,Independent,1155,1,1156,0.54
Sankarapuram,17,MAYILAMPARAI MARI A,Independent,844,0,844,0.39
Sankarapuram,18,RAJKUMAR  E,Independent,88,0,88,0.04
Sankarapuram,19,JAYAPRAKASH K,Independent,134,0,134,0.06
Sankarapuram,20,NOTA,None of the Above,944,9,953,0.44
Sankari,1,"SUNDARARAJAN, S.",All India Anna Dravida Munnetra Kazhagam,114376,1096,115472,49.72
Sankari,2,"RAJESH, K.M.",Dravida Munnetra Kazhagam,93897,1530,95427,41.09
Sankari,3,"SIVALINGAM, C.",Tamilaga Makkal Thannurimai Katchi,812,2,814,0.35
Sankari,4,"SENGODAN, K.",Makkal Needhi Maiam,3140,35,3175,1.37
Sankari,5,"CHELLAMUTHU, A.",Amma Makkal Munnettra Kazagam,1462,9,1471,0.63
Sankari,6,"SETTU, K.",My India Party,96,0,96,0.04
Sankari,7,"SHOBANA, S.",Naam Tamilar Katchi,10788,74,10862,4.68
Sankari,8,"RAVIKUMAR, P.",Ganasangam Party of India,197,3,200,0.09
Sankari,9,"AROKIASAMI, A.",Independent,135,0,135,0.06
Sankari,10,"GUNASEKARAN, M.",Independent,92,3,95,0.04
Sankari,11,"GOPALAKRISHNAN, S.",Independent,166,0,166,0.07
Sankari,12,"SATHISHKUMAR, V.",Independent,87,2,89,0.04
Sankari,13,"SENGOTEN, R.",Independent,97,0,97,0.04
Sankari,14,"DURAIRAJ, C.",Independent,209,2,211,0.09
Sankari,15,"PALANIYAPPAN, M.",Independent,524,1,525,0.23
Sankari,16,"BAKKIYAMANI, M.",Independent,846,1,847,0.36
Sankari,17,"PRABHU, K.",Independent,481,0,481,0.21
Sankari,18,"MANIVEL, P.",Independent,276,2,278,0.12
Sankari,19,"VIJAYAKUMAR, P.",Independent,55,0,55,0.02
Sankari,20,"VIJI @ VIJAYAN, K.",Independent,30,1,31,0.01
Sankari,21,"VENGADACHALAM, T.",Independent,33,0,33,0.01
Sankari,22,"JAGANATHAN, I.",Independent,99,0,99,0.04
Sankari,23,"JAGANNATHAN, M.",Independent,119,0,119,0.05
Sankari,24,NOTA,None of the Above,1453,16,1469,0.63
Sattur,1,"RAGHURAMAN,  A.R.R.",Dravida Munnetra Kazhagam,72949,1225,74174,38.68
Sattur,2,"RAVICHANDHRAN, R.K.",All India Anna Dravida Munnetra Kazhagam,62701,294,62995,32.85
Sattur,3,"ANGUSAMY,  S.",Anaithu Makkal Puratchi Katchi,411,3,414,0.22
Sattur,4,"SUBBURAMAN, P.",All India MGR Makkal Munnetra Kazhagam,153,3,156,0.08
Sattur,5,"PALANICHAMY, P.",Bahujan Dravida Party,96,1,97,0.05
Sattur,6,"PANDI, K.",Naam Tamilar Katchi,12478,148,12626,6.58
Sattur,7,"BHARATHI, M.",Indiya Jananayaka Katchi,1722,29,1751,0.91
Sattur,8,"MARIKANNAN, G.",Puthiya Tamilagam,1584,15,1599,0.83
Sattur,9,"RAJAVARMAN, M.S.R.",Amma Makkal Munnettra Kazagam,32693,223,32916,17.16
Sattur,10,"RAJKUMAR, R.",My India Party,186,2,188,0.1
Sattur,11,"JEYAGANESH, K.",Veerath Thiyagi Viswanathadoss Thozhilalarkal Katchi,166,0,166,0.09
Sattur,12,"ANTHONYRAJ,  A.",Independent,57,0,57,0.03
Sattur,13,"KARUTHAPANDIAN, S.",Independent,136,0,136,0.07
Sattur,14,"GURUSAMY, P.",Independent,94,0,94,0.05
Sattur,15,"SARAVANAKUMAR, M.",Independent,634,1,635,0.33
Sattur,16,"SUBRAMANIAN, S.",Independent,551,0,551,0.29
Sattur,17,"SENTHUR PANDIAN, R.",Independent,405,1,406,0.21
Sattur,18,"CHELLAPANDIAN,  P.",Independent,368,1,369,0.19
Sattur,19,"DHAMODHARAN,  S.",Independent,118,1,119,0.06
Sattur,20,"BALA SUBRAMANIAN, R.",Independent,61,1,62,0.03
Sattur,21,"BALAMURUGAN, K.",Independent,156,1,157,0.08
Sattur,22,"PRABAKARAN, J.",Independent,60,0,60,0.03
Sattur,23,"MAHESKUMAR, M",Independent,41,0,41,0.02
Sattur,24,"MANOHARAN, V.",Independent,51,0,51,0.03
Sattur,25,"MARIAPPAN, M.",Independent,123,1,124,0.06
Sattur,26,"RAGU, B.",Independent,331,1,332,0.17
Sattur,27,"RAMESH, A.",Independent,210,0,210,0.11
Sattur,28,NOTA,None of the Above,1280,17,1297,0.68
Senthamangalam,1,CHANDRAN S,All India Anna Dravida Munnetra Kazhagam,79703,485,80188,40.25
Senthamangalam,2,PONNUSAMY K,Dravida Munnetra Kazhagam,89146,1535,90681,45.51
Senthamangalam,3,CHANDRAN P,Amma Makkal Munnettra Kazagam,827,4,831,0.42
Senthamangalam,4,SELVARAJ V,Indiya Jananayaka Katchi,428,3,431,0.22
Senthamangalam,5,ROHINI T,Naam Tamilar Katchi,11534,120,11654,5.85
Senthamangalam,6,SANKAR P,Independent,194,1,195,0.1
Senthamangalam,7,CHANDRASEKARAN C,Independent,11328,43,11371,5.71
Senthamangalam,8,THIYAGARAJAN C,Independent,202,0,202,0.1
Senthamangalam,9,DINESH C,Independent,87,0,87,0.04
Senthamangalam,10,DURAIRAJ S,Independent,131,0,131,0.07
Senthamangalam,11,PRASATH S,Independent,116,3,119,0.06
Senthamangalam,12,MUTHUSAMY C,Independent,227,0,227,0.11
Senthamangalam,13,RANCHITH C,Independent,136,1,137,0.07
Senthamangalam,14,RAMESH R,Independent,250,1,251,0.13
Senthamangalam,15,RAMASAMY K.V,Independent,672,0,672,0.34
Senthamangalam,16,NOTA,None of the Above,2044,14,2058,1.03
Sholavandan,1,MANICKAM K,All India Anna Dravida Munnetra Kazhagam,66792,403,67195,38.32
Sholavandan,2,VENKATESAN A,Dravida Munnetra Kazhagam,83247,993,84240,48.04
Sholavandan,3,JEYALAKSHMI M,Desiya Murpokku Dravida Kazhagam,3534,48,3582,2.04
Sholavandan,4,INDURANI S,Puthiya Tamilagam,248,2,250,0.14
Sholavandan,5,ESWARI T,Communist Party of India  (Marxist-Leninist)  (Liberation),121,4,125,0.07
Sholavandan,6,SILAMBARASAN P,Bahujan Dravida Party,143,3,146,0.08
Sholavandan,7,SENGANNAN G,Naam Tamilar Katchi,13783,153,13936,7.95
Sholavandan,8,YOGANATHAN S,Makkal Needhi Maiam,3000,31,3031,1.73
Sholavandan,9,RAJKUMAR K,My India Party,71,0,71,0.04
Sholavandan,10,KATHIRESAN P,Independent,102,2,104,0.06
Sholavandan,11,KANDAVEL S,Independent,292,2,294,0.17
Sholavandan,12,KRISHNASAMY P,Independent,81,3,84,0.05
Sholavandan,13,SEKAR N,Independent,70,0,70,0.04
Sholavandan,14,DHANAGOPAL S,Independent,86,2,88,0.05
Sholavandan,15,MALAICHAMY A,Independent,133,0,133,0.08
Sholavandan,16,MOORTHY P,Independent,200,0,200,0.11
Sholavandan,17,MOORTHI M,Independent,363,0,363,0.21
Sholavandan,18,RAJKUMAR V,Independent,347,6,353,0.2
Sholavandan,19,VARATHARAJAN C,Independent,89,0,89,0.05
Sholavandan,20,VETRIVEL J,Independent,46,0,46,0.03
Sholavandan,21,NOTA,None of the Above,946,15,961,0.55
Sholinghur,1,M.GIRIDHARAN,Bahujan Samaj Party,611,3,614,0.27
Sholinghur,2,A.M.MUNIRATHINAM,Indian National Congress,109138,1090,110228,49.18
Sholinghur,3,A.M.KRISHNAN,Pattali Makkal Katchi,82919,611,83530,37.27
Sholinghur,4,N.G.PARTHIBAN,Amma Makkal Munnettra Kazagam,12877,102,12979,5.79
Sholinghur,5,Y.R.PAVENDHAN,Naam Tamilar Katchi,9580,76,9656,4.31
Sholinghur,6,R.VINOTH,Veerath Thiyagi Viswanathadoss Thozhilalarkal Katchi,131,1,132,0.06
Sholinghur,7,G.VIJAYAKUMAR,Desiya Sirupanmayinar Makkal Iyakkam,222,0,222,0.1
Sholinghur,8,R.JAWAHAR,Makkal Needhi Maiam,1649,15,1664,0.74
Sholinghur,9,T.RAJENDRAN,Independent,1014,1,1015,0.45
Sholinghur,10,R.ELUMALAI,Independent,111,1,112,0.05
Sholinghur,11,K.SEKAR,Independent,121,0,121,0.05
Sholinghur,12,A.PALANI,Independent,466,0,466,0.21
Sholinghur,13,P.PARTHIBAN,Independent,204,1,205,0.09
Sholinghur,14,J.BALAJI,Independent,464,3,467,0.21
Sholinghur,15,K.MANI,Independent,369,3,372,0.17
Sholinghur,16,N.MANI,Independent,326,0,326,0.15
Sholinghur,17,C.MUNIRATHINAM,Independent,174,0,174,0.08
Sholinghur,18,M.MUNIRATHINAM,Independent,585,2,587,0.26
Sholinghur,19,NOTA,None of the Above,1234,5,1239,0.55
Shozhinganallur,1,S.ARAVINDRAMESH,Dravida Munnetra Kazhagam,170675,883,171558,44.18
Shozhinganallur,2,K.P.KANDAN,All India Anna Dravida Munnetra Kazhagam,135834,319,136153,35.06
Shozhinganallur,3,G.PRAKASH ROBERT,Bahujan Samaj Party,551,3,554,0.14
Shozhinganallur,4,R.MURUGAN,Desiya Murpokku Dravida Kazhagam,3903,9,3912,1.01
Shozhinganallur,5,T.ELUMALAI,Anna MGR Dravida Munnetra Kazhagam,160,0,160,0.04
Shozhinganallur,6,S.MICHAEL,Naam Tamilar Katchi,38825,47,38872,10.01
Shozhinganallur,7,RAJIV KUMAR,Makkal Needhi Maiam,30229,55,30284,7.8
Shozhinganallur,8,M.RAJESWARIPRIYA,Anaithu Makkal Arasiyal Katchi,426,1,427,0.11
Shozhinganallur,9,A.I.AHAMED SHAH,Independent,171,1,172,0.04
Shozhinganallur,10,H.ARAVINDHKUMAR,Independent,448,4,452,0.12
Shozhinganallur,11,P.ARULRAJ,Independent,67,5,72,0.02
Shozhinganallur,12,R.RAVICHANDRAN,Independent,95,0,95,0.02
Shozhinganallur,13,Dr. V.KANDAN,Independent,146,1,147,0.04
Shozhinganallur,14,D.KALANITHI,Independent,96,0,96,0.02
Shozhinganallur,15,D.SRINIVASAN,Independent,149,0,149,0.04
Shozhinganallur,16,K.SURJITHKUMAR,Independent,674,2,676,0.17
Shozhinganallur,17,S.SENTHIL,Independent,477,0,477,0.12
Shozhinganallur,18,K.SENTHILKUMAR,Independent,310,0,310,0.08
Shozhinganallur,19,R.SELVAVIGNESH,Independent,176,0,176,0.05
Shozhinganallur,20,A.DHANASEKAR,Independent,57,0,57,0.01
Shozhinganallur,21,K.NARASIMMAN,Independent,58,0,58,0.01
Shozhinganallur,22,S.PRITHIVIRAJ,Independent,45,0,45,0.01
Shozhinganallur,23,A.MOHAMMED GANI,Independent,45,0,45,0.01
Shozhinganallur,24,E.RAJESH,Independent,127,0,127,0.03
Shozhinganallur,25,D.VENUGOPAL,Independent,117,0,117,0.03
Shozhinganallur,26,G.VELAVAN,Independent,134,0,134,0.03
Shozhinganallur,27,NOTA,None of the Above,3021,9,3030,0.78
Singanallur,1,"Karthik, N",Dravida Munnetra Kazhagam,68984,1406,70390,34.84
Singanallur,2,"Jayaram, K.R",All India Anna Dravida Munnetra Kazhagam,80437,807,81244,40.22
Singanallur,3,"Sasikumar, M",Anna Dravidar Kazhagam,209,2,211,0.1
Singanallur,4,"SenthilKumar, S",United States of India Party,94,0,94,0.05
Singanallur,5,"Selva, S.R",Amma Makkal Munnettra Kazagam,1722,11,1733,0.86
Singanallur,6,"Narmadha, R",Naam Tamilar Katchi,8311,55,8366,4.14
Singanallur,7,"Palanisamy, N",My India Party,112,1,113,0.06
Singanallur,8,"Mahendran, R",Makkal Needhi Maiam,36553,302,36855,18.24
Singanallur,9,"Akbar Ali, A",Independent,86,0,86,0.04
Singanallur,10,"Karthick, N",Independent,72,1,73,0.04
Singanallur,11,"Karthik, N",Independent,132,3,135,0.07
Singanallur,12,"Krishnan, V",Independent,30,0,30,0.01
Singanallur,13,"Kumar babu, K",Independent,87,0,87,0.04
Singanallur,14,"Gowtham, P",Independent,65,2,67,0.03
Singanallur,15,"Chanthirika, R",Independent,200,1,201,0.1
Singanallur,16,"Nabas Sherif, M",Independent,257,0,257,0.13
Singanallur,17,"Nagarajan, J",Independent,163,0,163,0.08
Singanallur,18,Praveen Venkatachalam,Independent,187,1,188,0.09
Singanallur,19,"Maniraj, K",Independent,87,2,89,0.04
Singanallur,20,"Mohandass, N",Independent,121,0,121,0.06
Singanallur,21,"Viju Alban Prakash, V",Independent,86,0,86,0.04
Singanallur,22,NOTA,None of the Above,1415,17,1432,0.71
Sirkazhi,1,PANNEERSELVAM,Dravida Munnetra Kazhagam,92866,1191,94057,49.16
Sirkazhi,2,P.V.BHARATHI,All India Anna Dravida Munnetra Kazhagam,81235,674,81909,42.81
Sirkazhi,3,SRITHAR,Bahujan Samaj Party,490,5,495,0.26
Sirkazhi,4,Kamban,Anaithu Makkal Arasiyal Katchi,76,3,79,0.04
Sirkazhi,5,Kavitha,Naam Tamilar Katchi,10966,47,11013,5.76
Sirkazhi,6,BALU,Amma Makkal Munnettra Kazagam,1301,7,1308,0.68
Sirkazhi,7,PRABU,Makkal Needhi Maiam,990,10,1000,0.52
Sirkazhi,8,ANUSUYA,Independent,76,1,77,0.04
Sirkazhi,9,Silambarasan,Independent,121,1,122,0.06
Sirkazhi,10,BARATHI,Independent,287,1,288,0.15
Sirkazhi,11,NOTA,None of the Above,974,3,977,0.51
Sivaganga,1,S. Gunasekaran,Communist Party of India,69101,1799,70900,35.09
Sivaganga,2,PR. Senthilnathan,All India Anna Dravida Munnetra Kazhagam,81267,886,82153,40.66
Sivaganga,3,K. Anbarasan,Amma Makkal Munnettra Kazagam,19631,193,19824,9.81
Sivaganga,4,N. Pandimuthu,My India Party,369,4,373,0.18
Sivaganga,5,R. Mallika,Naam Tamilar Katchi,22301,199,22500,11.14
Sivaganga,6,Vadivel. C,Anaithu Makkal Puratchi Katchi,239,2,241,0.12
Sivaganga,7,Joseph. C,Makkal Needhi Maiam,2076,29,2105,1.04
Sivaganga,8,K. Kalaiselvam,Independent,120,3,123,0.06
Sivaganga,9,C. Kaningprabhu,Independent,109,3,112,0.06
Sivaganga,10,R. Gunasekaran,Independent,145,10,155,0.08
Sivaganga,11,M. Thirukumaran,Independent,124,3,127,0.06
Sivaganga,12,Dr. A. Parthasarathy,Independent,342,3,345,0.17
Sivaganga,13,M. Ravi,Independent,175,0,175,0.09
Sivaganga,14,Vimalraj,Independent,307,2,309,0.15
Sivaganga,15,P. Viswanathan,Independent,1318,14,1332,0.66
Sivaganga,16,NOTA,None of the Above,1258,12,1270,0.63
Sivakasi,1,Ashokan.G,Indian National Congress,77788,1159,78947,42.66
Sivakasi,2,Ananthalakshmi,Bahujan Samaj Party,432,6,438,0.24
Sivakasi,3,Lakshmi Ganesan,All India Anna Dravida Munnetra Kazhagam,61367,261,61628,33.3
Sivakasi,4,KANNAN.K,Veerath Thiyagi Viswanathadoss Thozhilalarkal Katchi,423,3,426,0.23
Sivakasi,5,KARUPPASAMY.S,Anaithu Makkal Puratchi Katchi,314,2,316,0.17
Sivakasi,6,KALYANASUNDARI.M,My India Party,188,3,191,0.1
Sivakasi,7,Kanagapriya.R,Naam Tamilar Katchi,20754,111,20865,11.28
Sivakasi,8,Samikkalai.G,Amma Makkal Munnettra Kazagam,9751,142,9893,5.35
Sivakasi,9,MGR NAMBBI,All India MGR Makkal Munnetra Kazhagam,107,0,107,0.06
Sivakasi,10,PALANICHAMY.P,Bahujan Dravida Party,61,0,61,0.03
Sivakasi,11,Mugunthan.S,Makkal Needhi Maiam,6053,37,6090,3.29
Sivakasi,12,JEEVANANTHAM.G,Republican Party of India (Athawale),77,1,78,0.04
Sivakasi,13,Ashokkumar.C,Independent,86,2,88,0.05
Sivakasi,14,Anbalagan.P,Independent,125,1,126,0.07
Sivakasi,15,GANESAN.R,Independent,151,1,152,0.08
Sivakasi,16,Karthik.N,Independent,319,0,319,0.17
Sivakasi,17,KESAVAKUMAR.D,Independent,442,0,442,0.24
Sivakasi,18,Thangaraj.S,Independent,233,1,234,0.13
Sivakasi,19,DHARMALINGAM.M,Independent,330,0,330,0.18
Sivakasi,20,Pandiarajan.S,Independent,113,1,114,0.06
Sivakasi,21,Balakrishnan.N,Independent,405,9,414,0.22
Sivakasi,22,MAYILVAGANAN.G,Independent,100,1,101,0.05
Sivakasi,23,MARIMUTHU.M,Independent,220,1,221,0.12
Sivakasi,24,LAKSHMANAN.E,Independent,1410,20,1430,0.77
Sivakasi,25,VINOTHKUMAR.M,Independent,245,0,245,0.13
Sivakasi,26,JOYSMARY.T,Independent,64,0,64,0.03
Sivakasi,27,NOTA,None of the Above,1709,18,1727,0.93
Sriperumbudur,1,SELVAPERUNTHAGAI,Indian National Congress,114554,799,115353,43.65
Sriperumbudur,2,PALANI,All India Anna Dravida Munnetra Kazhagam,104017,457,104474,39.53
Sriperumbudur,3,VINOTH,Bahujan Samaj Party,802,1,803,0.3
Sriperumbudur,4,THANIGAIVEL,Makkal Needhi Maiam,8838,32,8870,3.36
Sriperumbudur,5,PUSHPARAJ,Naam Tamilar Katchi,21998,36,22034,8.34
Sriperumbudur,6,PERUMAL,Amma Makkal Munnettra Kazagam,3125,19,3144,1.19
Sriperumbudur,7,LOKESH,Desiya Makkal Sakthi Katchi,123,0,123,0.05
Sriperumbudur,8,SAROJA,Independent,280,2,282,0.11
Sriperumbudur,9,SUDHAKAR,Independent,88,12,100,0.04
Sriperumbudur,10,DEVARAJAN,Independent,114,15,129,0.05
Sriperumbudur,11,PARTHIBAN,Independent,74,0,74,0.03
Sriperumbudur,12,LEENA,Independent,138,0,138,0.05
Sriperumbudur,13,VASANTHI,Independent,123,1,124,0.05
Sriperumbudur,14,VEDHAGIRI,Independent,132,3,135,0.05
Sriperumbudur,15,VAIRAMUTHU,Independent,6325,15,6340,2.4
Sriperumbudur,16,NOTA,None of the Above,2132,7,2139,0.81
Srirangam,1,KuPa Krishnan,All India Anna Dravida Munnetra Kazhagam,93131,858,93989,39.12
Srirangam,2,G.Selvakumar,Bahujan Samaj Party,805,6,811,0.34
Srirangam,3,Palaniyandi.M,Dravida Munnetra Kazhagam,112009,1895,113904,47.41
Srirangam,4,Annalakshmi,Desiya Makkal Sakthi Katchi,606,2,608,0.25
Srirangam,5,Sarubala.R.Thondaiman,Amma Makkal Munnettra Kazagam,3448,39,3487,1.45
Srirangam,6,K.Selvarathi,Naam Tamilar Katchi,17793,118,17911,7.46
Srirangam,7,Daniel Jude Martin,Makkal Munnetra Peravai,207,3,210,0.09
Srirangam,8,P.Balasubramanian,Samaniya Makkal Nala Katchi,88,1,89,0.04
Srirangam,9,S.Francis Mery,Indiya Jananayaka Katchi,1062,5,1067,0.44
Srirangam,10,M.Amsavalli,Independent,95,2,97,0.04
Srirangam,11,R.Uma,Independent,157,6,163,0.07
Srirangam,12,S.Suresh,Independent,386,2,388,0.16
Srirangam,13,V.Sethumadhavan,Independent,594,0,594,0.25
Srirangam,14,P.Ravichandran,Independent,422,1,423,0.18
Srirangam,15,Y.Jacob,Independent,4031,51,4082,1.7
Srirangam,16,NOTA,None of the Above,2391,26,2417,1.01
Srivaikuntam,1,Amirtharaj .S,Indian National Congress,75086,1757,76843,46.75
Srivaikuntam,2,S.P.SHUNMUGANATHAN,All India Anna Dravida Munnetra Kazhagam,58583,888,59471,36.18
Srivaikuntam,3,Arun B,Puthiya Tamilagam,437,7,444,0.27
Srivaikuntam,4,Arulmathi Yesuvadiyal,Aanaithinthiya Jananayaka Pathukappu Kazhagam,95,1,96,0.06
Srivaikuntam,5,ERAL S. RAMESH,Amma Makkal Munnettra Kazagam,10074,129,10203,6.21
Srivaikuntam,6,R.Chandra Sekar,Makkal Needhi Maiam,1345,10,1355,0.82
Srivaikuntam,7,P.Subbiah Pandian,Naam Tamilar Katchi,12552,154,12706,7.73
Srivaikuntam,8,SURESH PERUMAL S,Naam Indiar Party,232,1,233,0.14
Srivaikuntam,9,Jegan,Anna Dravidar Kazhagam,104,2,106,0.06
Srivaikuntam,10,ALLWIN DURAISINGH P,Independent,51,1,52,0.03
Srivaikuntam,11,Esakki Raja K,Independent,336,5,341,0.21
Srivaikuntam,12,Kirushnavel R,Independent,103,0,103,0.06
Srivaikuntam,13,Sankara Subramanian M,Independent,129,0,129,0.08
Srivaikuntam,14,SARAVANAN G,Independent,79,1,80,0.05
Srivaikuntam,15,Sudalaimuthu Perumal,Independent,139,1,140,0.09
Srivaikuntam,16,Sethuramalingam S,Independent,311,1,312,0.19
Srivaikuntam,17,Durai Singh J,Independent,493,1,494,0.3
Srivaikuntam,18,Ponnudurai I,Independent,297,0,297,0.18
Srivaikuntam,19,Malaiandi R,Independent,56,0,56,0.03
Srivaikuntam,20,VINSTON ANTO S,Independent,37,1,38,0.02
Srivaikuntam,21,Joseph Leon,Independent,126,5,131,0.08
Srivaikuntam,22,NOTA,None of the Above,749,7,756,0.46
Srivilliputhur,1,"MADHAVARAO, P.S.W.",Indian National Congress,56450,1287,57737,31.2
Srivilliputhur,2,"MANRAJ, E.M.",All India Anna Dravida Munnetra Kazhagam,70081,394,70475,38.09
Srivilliputhur,3,"ABINAYA, B.",Naam Tamilar Katchi,20038,310,20348,11
Srivilliputhur,4,"IRULANDI, Dr. V.",Tamil Nadu Ilangyar Katchi,935,7,942,0.51
Srivilliputhur,5,"GURUVAIYA, K.",Makkal Needhi Maiam,3468,44,3512,1.9
Srivilliputhur,6,"SANGEETHAPRIYA, S.",Amma Makkal Munnettra Kazagam,23479,203,23682,12.8
Srivilliputhur,7,"SHANTHI, S.",Puthiya Tamilagam,4917,68,4985,2.69
Srivilliputhur,8,"PANDIYARAJ, K.",Anaithu Makkal Puratchi Katchi,209,0,209,0.11
Srivilliputhur,9,"VEERAPANDI, K.",My India Party,175,2,177,0.1
Srivilliputhur,10,"KANNAN, A.",Independent,237,1,238,0.13
Srivilliputhur,11,"GURUVAIYA, G.",Independent,148,0,148,0.08
Srivilliputhur,12,"THAMARAISELVAM, K.",Independent,163,1,164,0.09
Srivilliputhur,13,"PRABHAKARAN, P.",Independent,201,1,202,0.11
Srivilliputhur,14,"MAHALAKSHMI, M.",Independent,189,2,191,0.1
Srivilliputhur,15,"MUTHULAKSHMI,R.",Independent,362,1,363,0.2
Srivilliputhur,16,NOTA,None of the Above,1642,24,1666,0.9
Sulur,1,KANDASAMY V.P.,All India Anna Dravida Munnetra Kazhagam,118221,747,118968,49.23
Sulur,2,PREMIER SELVAM (a)KALICHAMY M,Dravida Munnetra Kazhagam,85919,1117,87036,36.02
Sulur,3,ELANGOVAN. G,Naam Tamilar Katchi,14376,50,14426,5.97
Sulur,4,SENTHIL KUMAR. S.A.,Amma Makkal Munnettra Kazagam,4087,24,4111,1.7
Sulur,5,NAGARAJ. K,Ganasangam Party of India,240,1,241,0.1
Sulur,6,RANGANATHAN. A,Makkal Needhi Maiam,12592,66,12658,5.24
Sulur,7,JAGADHEESH. S,My India Party,126,2,128,0.05
Sulur,8,KANDASAMY T,Independent,82,1,83,0.03
Sulur,9,KARTHIKEYAN P,Independent,209,0,209,0.09
Sulur,10,SHANKAR GURU. M,Independent,191,5,196,0.08
Sulur,11,SHANMUGAM R,Independent,112,4,116,0.05
Sulur,12,SENTHIL KUMAR. S.A.P.,Independent,100,1,101,0.04
Sulur,13,SELVA KUMAR D,Independent,213,0,213,0.09
Sulur,14,SELVAN S,Independent,176,1,177,0.07
Sulur,15,PREM KUMAR P,Independent,380,0,380,0.16
Sulur,16,NOTA,None of the Above,2588,22,2610,1.08
Tambaram,1,Raja.S.R,Dravida Munnetra Kazhagam,115721,1119,116840,46.93
Tambaram,2,Chinnaiyah.T.K.M,All India Anna Dravida Munnetra Kazhagam,79509,507,80016,32.14
Tambaram,3,Harikrishnan.R,Bahujan Samaj Party,314,3,317,0.13
Tambaram,4,Abdulnazar P A,Tamil Nadu Ilangyar Katchi,1348,3,1351,0.54
Tambaram,5,Elango.Siva,Makkal Needhi Maiam,22466,64,22530,9.05
Tambaram,6,Karikalan.M,Amma Makkal Munnettra Kazagam,4194,13,4207,1.69
Tambaram,7,KAMATCHI U.,Anaithu Makkal Arasiyal Katchi,199,0,199,0.08
Tambaram,8,Sureshkumar.T,Naam Tamilar Katchi,19463,31,19494,7.83
Tambaram,9,Manojkumar A.,Shiv Sena,85,3,88,0.04
Tambaram,10,Ramu A,National Democratic Party of South India,53,3,56,0.02
Tambaram,11,Venkatesan.C,Veerath Thiyagi Viswanathadoss Thozhilalarkal Katchi,73,0,73,0.03
Tambaram,12,Justin Charles.P,Republican Party of India (Athawale),64,0,64,0.03
Tambaram,13,Anand Prabhu B.,Independent,122,0,122,0.05
Tambaram,14,Laksmanan N.,Independent,264,0,264,0.11
Tambaram,15,Kannairam.B,Independent,116,1,117,0.05
Tambaram,16,KRISHNA T V N H S R.,Independent,212,3,215,0.09
Tambaram,17,Sigamani S,Independent,247,0,247,0.1
Tambaram,18,Sivaraman.S,Independent,168,1,169,0.07
Tambaram,19,Thangaraj V.,Independent,46,1,47,0.02
Tambaram,20,Balakrishnan G.,Independent,46,0,46,0.02
Tambaram,21,Rathinakumar R.,Independent,149,2,151,0.06
Tambaram,22,Venkatesan Balaji B.,Independent,71,0,71,0.03
Tambaram,23,NOTA,None of the Above,2276,8,2284,0.92
Tenkasi,1,SELVA MOHANDAS PANDIAN.S,All India Anna Dravida Munnetra Kazhagam,88271,674,88945,41.54
Tenkasi,2,PALANI NADAR.S,Indian National Congress,87706,1609,89315,41.71
Tenkasi,3,UDHAYAKUMAR.K.M,Anna Dravidar Kazhagam,685,5,690,0.32
Tenkasi,4,CHANDRASEGAR.S,Puthiya Tamilagam,857,21,878,0.41
Tenkasi,5,SURESHKUMAR.S,Anna Puratchi Thalaivar Amma Dravida Munnetra Kazhagam,119,0,119,0.06
Tenkasi,6,SELVAKUMAR.R,Naam Indiar Party,317,2,319,0.15
Tenkasi,7,THIRUMALAIMUTHU.R,Makkal Needhi Maiam,2169,19,2188,1.02
Tenkasi,8,MOHAMED.S,Amma Makkal Munnettra Kazagam,9839,105,9944,4.64
Tenkasi,9,MUGUNDHAN.K,My India Party,194,1,195,0.09
Tenkasi,10,VINCENTRAJ.R,Naam Tamilar Katchi,15213,123,15336,7.16
Tenkasi,11,JEGANATHAN.M,Anaithu Makkal Puratchi Katchi,409,7,416,0.19
Tenkasi,12,AROKKIYA PRABHU.J,Independent,426,2,428,0.2
Tenkasi,13,DOCTOR. KARUPPASAMY.S,Independent,214,2,216,0.1
Tenkasi,14,PALANIKUMAR.A,Independent,174,1,175,0.08
Tenkasi,15,PALANIMURUGAN.P,Independent,627,1,628,0.29
Tenkasi,16,MADASAMY.A,Independent,1974,4,1978,0.92
Tenkasi,17,RAMESH.R,Independent,684,0,684,0.32
Tenkasi,18,REEGANKUMAR. M,Independent,495,0,495,0.23
Tenkasi,19,NOTA,None of the Above,1146,13,1159,0.54
Thalli,1,RAMACHANDRAN.T,Communist Party of India,119621,1020,120641,62.18
Thalli,2,Dr.NAGESH KUMAR.C,Bharatiya Janata Party,64131,284,64415,33.2
Thalli,3,ASHOK KUMAR.V,Indiya Jananayaka Katchi,782,6,788,0.41
Thalli,4,USHA.M,New Generation People’s Party,208,1,209,0.11
Thalli,5,SEKAR.M.V,Amma Makkal Munnettra Kazagam,342,4,346,0.18
Thalli,6,MARY SELVARANI.R,Naam Tamilar Katchi,3760,16,3776,1.95
Thalli,7,RAVI.G,Samajwadi Party,162,0,162,0.08
Thalli,8,JANAKI.G,Veerath Thiyagi Viswanathadoss Thozhilalarkal Katchi,137,1,138,0.07
Thalli,9,KUMAR.M,Independent,419,3,422,0.22
Thalli,10,DEVAPPA@DEVAGOWDA.Y,Independent,219,3,222,0.11
Thalli,11,RAVI MUNISWAMY,Independent,352,1,353,0.18
Thalli,12,VASANTHAMMA.N,Independent,582,2,584,0.3
Thalli,13,NOTA,None of the Above,1963,3,1966,1.01
Thanjavur,1,"ARIVUDAINAMBI, V.",All India Anna Dravida Munnetra Kazhagam,56173,450,56623,29.06
Thanjavur,2,"DR.RAMANATHAN, P.",Desiya Murpokku Dravida Kazhagam,4190,56,4246,2.18
Thanjavur,3,"KARIKALA CHOLAN, S.",Nationalist Congress Party,274,7,281,0.14
Thanjavur,4,"NEELAMEGAM, T.K.G.",Dravida Munnetra Kazhagam,100786,2986,103772,53.25
Thanjavur,5,"SUNDARAMOHAN, G.",Makkal Needhi Maiam,9600,81,9681,4.97
Thanjavur,6,"SUBADEVI, R.",Naam Tamilar Katchi,17220,146,17366,8.91
Thanjavur,7,"XAVIER, A.",People's Party of India(secular),214,3,217,0.11
Thanjavur,8,"SANTHOSH, M.",Independent,119,3,122,0.06
Thanjavur,9,"SABTHAGIRI, R.",Independent,100,1,101,0.05
Thanjavur,10,"DINESH BABU, D.",Independent,141,1,142,0.07
Thanjavur,11,"BHARATH, B.",Independent,105,5,110,0.06
Thanjavur,12,"VASUKI, N.",Independent,256,4,260,0.13
Thanjavur,13,NOTA,None of the Above,1915,23,1938,0.99
Thiru-Vi-Ka-Nagar,1,KALYANI.P.L,All India Anna Dravida Munnetra Kazhagam,26602,112,26714,19.98
Thiru-Vi-Ka-Nagar,2,SIVAKUMAR.P,Dravida Munnetra Kazhagam,81283,444,81727,61.13
Thiru-Vi-Ka-Nagar,3,SEKAR.M.P,Desiya Murpokku Dravida Kazhagam,1785,2,1787,1.34
Thiru-Vi-Ka-Nagar,4,BAGAVATH SINGH.M,Bahujan Samaj Party,352,3,355,0.27
Thiru-Vi-Ka-Nagar,5,ILLAVANJI.Dr.R,Naam Tamilar Katchi,10892,29,10921,8.17
Thiru-Vi-Ka-Nagar,6,OBATH.S,Makkal Needhi Maiam,9670,40,9710,7.26
Thiru-Vi-Ka-Nagar,7,PRABHAKARAN.K,Makkalatchi Katchi,78,1,79,0.06
Thiru-Vi-Ka-Nagar,8,RAVIKUMAR.S,Republican Party of India  (Sivaraj),62,0,62,0.05
Thiru-Vi-Ka-Nagar,9,RAVIPARAIYANAR.D,Republican Party of India (Athawale),41,0,41,0.03
Thiru-Vi-Ka-Nagar,10,UDAYA CHANDRAN .R,Independent,76,1,77,0.06
Thiru-Vi-Ka-Nagar,11,KALYANI.K,Independent,128,1,129,0.1
Thiru-Vi-Ka-Nagar,12,KOLANJI.M,Independent,85,0,85,0.06
Thiru-Vi-Ka-Nagar,13,GOVINDARAJ.G,Independent,33,0,33,0.02
Thiru-Vi-Ka-Nagar,14,SANTHANU.S,Independent,38,0,38,0.03
Thiru-Vi-Ka-Nagar,15,SIHAMANI.G,Independent,213,1,214,0.16
Thiru-Vi-Ka-Nagar,16,SUNDAR.G,Independent,144,0,144,0.11
Thiru-Vi-Ka-Nagar,17,SELVAKUMAR.A,Independent,136,0,136,0.1
Thiru-Vi-Ka-Nagar,18,SEKAR.E,Independent,124,1,125,0.09
Thiru-Vi-Ka-Nagar,19,PREMKUMAR.G,Independent,44,0,44,0.03
Thiru-Vi-Ka-Nagar,20,BIRLABOSE.M,Independent,29,0,29,0.02
Thiru-Vi-Ka-Nagar,21,MALATHI.S,Independent,57,0,57,0.04
Thiru-Vi-Ka-Nagar,22,RANGANATHAN.M,Independent,37,0,37,0.03
Thiru-Vi-Ka-Nagar,23,RAMESH BABU.M,Independent,105,1,106,0.08
Thiru-Vi-Ka-Nagar,24,NOTA,None of the Above,1042,4,1046,0.78
Thirumangalam,1,UDHAYAKUMAR R B,All India Anna Dravida Munnetra Kazhagam,99294,1044,100338,45.51
Thirumangalam,2,MANIMARAN M,Dravida Munnetra Kazhagam,84381,1870,86251,39.12
Thirumangalam,3,ATHI NARAYANAN K,Amma Makkal Munnettra Kazagam,13554,226,13780,6.25
Thirumangalam,4,ARUMUGAM K,Lok Jan Shakti Party,119,3,122,0.06
Thirumangalam,5,SARAL M,Naam Tamilar Katchi,11375,218,11593,5.26
Thirumangalam,6,NIRMAL M,My India Party,119,3,122,0.06
Thirumangalam,7,MARIKANNAN A,National Democratic Party of South India,95,3,98,0.04
Thirumangalam,8,RAMKUMAR M,Makkal Needhi Maiam,2748,27,2775,1.26
Thirumangalam,9,ALAGARSAMY M,Independent,71,0,71,0.03
Thirumangalam,10,KALI A,Independent,44,1,45,0.02
Thirumangalam,11,CHANDRASEKARAN R,Independent,42,2,44,0.02
Thirumangalam,12,THIRALIPANDI N,Independent,78,4,82,0.04
Thirumangalam,13,DURAIPANDI B,Independent,61,1,62,0.03
Thirumangalam,14,BALAMURUGAN N R,Independent,129,2,131,0.06
Thirumangalam,15,MUTHURAJA M,Independent,187,3,190,0.09
Thirumangalam,16,MUTHUVELRAJ P,Independent,501,2,503,0.23
Thirumangalam,17,RAMANATHAN A,Independent,683,1,684,0.31
Thirumangalam,18,RAMANATHAN M,Independent,433,0,433,0.2
Thirumangalam,19,RAMAMOORTHI R,Independent,163,2,165,0.07
Thirumangalam,20,RAJANBABU P,Independent,276,2,278,0.13
Thirumangalam,21,VEERANAN S,Independent,1566,10,1576,0.71
Thirumangalam,22,VEERAMANI V,Independent,41,1,42,0.02
Thirumangalam,23,VAIRASEEMAN G,Independent,64,0,64,0.03
Thirumangalam,24,JEGADEESH KUMAR R,Independent,74,1,75,0.03
Thirumangalam,25,NOTA,None of the Above,958,13,971,0.44
Thirumayam,1,S.REGUPATHY,Dravida Munnetra Kazhagam,70594,755,71349,41
Thirumayam,2,P.K.VAIRAMUTHU,All India Anna Dravida Munnetra Kazhagam,69595,372,69967,40.2
Thirumayam,3,S. GANDIPAN,My India Party,554,0,554,0.32
Thirumayam,4,R.SIVAKUMAR,Puthiya Tamilagam,236,2,238,0.14
Thirumayam,5,U.SIVARAMAN,Naam Tamilar Katchi,11019,42,11061,6.36
Thirumayam,6,R.THIRUMENI,Makkal Needhi Maiam,1350,6,1356,0.78
Thirumayam,7,S.PURACHIBALAN,Anna Dravidar Kazhagam,74,0,74,0.04
Thirumayam,8,S.MUNIARAJU,Amma Makkal Munnettra Kazagam,1485,18,1503,0.86
Thirumayam,9,C. ALAGU SUBBIAH,Independent,408,4,412,0.24
Thirumayam,10,M.KARTHICK,Independent,65,0,65,0.04
Thirumayam,11,R.SUNDARAM,Independent,69,1,70,0.04
Thirumayam,12,K.SELVAKUMAR,Independent,54,0,54,0.03
Thirumayam,13,M.SELVAKUMAR,Independent,87,0,87,0.05
Thirumayam,14,S.SELVAKUMAR,Independent,109,0,109,0.06
Thirumayam,15,M.SELVAKUMAR,Independent,315,0,315,0.18
Thirumayam,16,K.SELVAKUMAR,Independent,15111,33,15144,8.7
Thirumayam,17,M.SELVAKUMAR,Independent,456,0,456,0.26
Thirumayam,18,M. DURAIRAJAN,Independent,365,0,365,0.21
Thirumayam,19,R. PALANIYAPPAN,Independent,92,0,92,0.05
Thirumayam,20,S.MANIKANDAN,Independent,66,0,66,0.04
Thirumayam,21,AL.MATHIALAGAN,Independent,51,0,51,0.03
Thirumayam,22,MUTHUADAIKKAN @ ADAIKKALAM,Independent,73,1,74,0.04
Thirumayam,23,NOTA,None of the Above,568,1,569,0.33
Thiruparankundram,1,PONNUTHAI,Communist Party of India  (Marxist),73032,1162,74194,31.46
Thiruparankundram,2,"RAJANCHELLAPPA, V.V.",All India Anna Dravida Munnetra Kazhagam,103059,624,103683,43.96
Thiruparankundram,3,"SAVITHA, R.",Anna MGR Dravida Makkal Kalgam,591,1,592,0.25
Thiruparankundram,4,"DAVID ANNADURAI, K.",Amma Makkal Munnettra Kazagam,10120,70,10190,4.32
Thiruparankundram,5,"BHARANIRAJAN, M.",Makkal Needhi Maiam,16662,88,16750,7.1
Thiruparankundram,6,"PALANIKUMAR, M.",Ambedkar Political Party,173,4,177,0.08
Thiruparankundram,7,"MURUGESAN, A.",My India Party,131,0,131,0.06
Thiruparankundram,8,"RAJAMANI, V.",Namadhu Makkal Katchi,537,1,538,0.23
Thiruparankundram,9,"REVATHY, R.",Naam Tamilar Katchi,22582,140,22722,9.63
Thiruparankundram,10,"ARUMUGAM, V.",Independent,2002,3,2005,0.85
Thiruparankundram,11,"ILANGOVAN, P.",Independent,114,0,114,0.05
Thiruparankundram,12,"UKKRA PANDIYAN, S.",Independent,301,1,302,0.13
Thiruparankundram,13,"KARUNAKARAN, M.",Independent,246,0,246,0.1
Thiruparankundram,14,"SANKAR THAYAL SHARMA, M.",Independent,80,0,80,0.03
Thiruparankundram,15,"SEKAR, S.",Independent,200,0,200,0.08
Thiruparankundram,16,"PACKIYASELVI, K.",Independent,401,1,402,0.17
Thiruparankundram,17,"BALAMURUGAN, R.",Independent,256,1,257,0.11
Thiruparankundram,18,"PILLAI, M.M.",Independent,283,1,284,0.12
Thiruparankundram,19,"MANIKANDAN, S.",Independent,81,1,82,0.03
Thiruparankundram,20,"MOHIDEEN ABDUL KADAR, M.K.",Independent,98,0,98,0.04
Thiruparankundram,21,"MURUGAN, K.R.",Independent,555,7,562,0.24
Thiruparankundram,22,"RADHA (A) GUNASEKARAN, M.",Independent,114,0,114,0.05
Thiruparankundram,23,"RAMACHANDRAN, K.",Independent,52,1,53,0.02
Thiruparankundram,24,NOTA,None of the Above,2039,34,2073,0.88
Thiruporur,1,V.K.Pakkiri Ambadkar,Bahujan Samaj Party,1129,6,1135,0.5
Thiruporur,2,Arumugam.K,Pattali Makkal Katchi,91388,619,92007,40.58
Thiruporur,3,Kothandapani.M,Amma Makkal Munnettra Kazagam,7629,33,7662,3.38
Thiruporur,4,S.S.Balaji,Viduthalai Chiruthaigal Katchi,92987,967,93954,41.44
Thiruporur,5,Mohana Sundari.S,Naam Tamilar Katchi,20354,74,20428,9.01
Thiruporur,6,Lavanya.N,Makkal Needhi Maiam,8125,69,8194,3.61
Thiruporur,7,U.Akbar Bhasha,Independent,267,1,268,0.12
Thiruporur,8,M.Duraisamy,Independent,190,3,193,0.09
Thiruporur,9,S.Nataraj,Independent,268,3,271,0.12
Thiruporur,10,D.Ravi,Independent,266,2,268,0.12
Thiruporur,11,A.Joshva,Independent,367,0,367,0.16
Thiruporur,12,NOTA,None of the Above,1971,11,1982,0.87
Thiruthuraipoondi,1,SURESH KUMAR C,All India Anna Dravida Munnetra Kazhagam,66683,341,67024,36.06
Thiruthuraipoondi,2,MARIMUTHU K,Communist Party of India,95785,1307,97092,52.23
Thiruthuraipoondi,3,AARTHI A,Naam Tamilar Katchi,15300,62,15362,8.26
Thiruthuraipoondi,4,PARIVENTHAN D,All India Samathuva Makhal Katchi,313,2,315,0.17
Thiruthuraipoondi,5,RAJANIKANTH S,Amma Makkal Munnettra Kazagam,3536,19,3555,1.91
Thiruthuraipoondi,6,SIVAPRAKASAM V,Independent,128,1,129,0.07
Thiruthuraipoondi,7,SURESH A K,Independent,184,6,190,0.1
Thiruthuraipoondi,8,SENGUTTUVAN M,Independent,133,3,136,0.07
Thiruthuraipoondi,9,THIRUVARUL SELVI V,Independent,138,1,139,0.07
Thiruthuraipoondi,10,THULASIRAMAN R,Independent,155,0,155,0.08
Thiruthuraipoondi,11,PARAMASIVAM K,Independent,476,0,476,0.26
Thiruthuraipoondi,12,NOTA,None of the Above,1310,3,1313,0.71
Thiruvaiyaru,1,ASWIN,Bahujan Samaj Party,530,0,530,0.25
Thiruvaiyaru,2,DURAI.CHANDRASEKARAN,Dravida Munnetra Kazhagam,101959,1251,103210,48.82
Thiruvaiyaru,3,"VENKATESAN, S.",Bharatiya Janata Party,49284,276,49560,23.44
Thiruvaiyaru,4,"UTHIRAPATHI, G.",Puthiya Tamilagam,1197,18,1215,0.57
Thiruvaiyaru,5,"KARTHIKEYAN, V.",Amma Makkal Munnettra Kazagam,37310,159,37469,17.72
Thiruvaiyaru,6,"SIVARAMAN, T.","Makkal Sananayaga Kudiyarasu Katchi,",236,0,236,0.11
Thiruvaiyaru,7,"SENTHILNATHAN, D.",Naam Tamilar Katchi,15727,93,15820,7.48
Thiruvaiyaru,8,"BACKIYARAJ, V.",Anaithu Makkal Arasiyal Katchi,252,0,252,0.12
Thiruvaiyaru,9,"VIJAYAKUMAR, S.",Anna Puratchi Thalaivar Amma Dravida Munnetra Kazhagam,255,2,257,0.12
Thiruvaiyaru,10,"SINGARAVADIVEL, S.",Independent,238,2,240,0.11
Thiruvaiyaru,11,"THIRUMARAN, P.S.",Independent,1089,4,1093,0.52
Thiruvaiyaru,12,"RAJKUMAR, R.",Independent,367,1,368,0.17
Thiruvaiyaru,13,NOTA,None of the Above,1173,7,1180,0.56
Thiruvallur,1,"RAAJENDRAN, V.G.",Dravida Munnetra Kazhagam,106316,1393,107709,50.27
Thiruvallur,2,"DOSS, D.",Bahujan Samaj Party,2314,15,2329,1.09
Thiruvallur,3,"RAMANAH, BE VEE",All India Anna Dravida Munnetra Kazhagam,84508,500,85008,39.68
Thiruvallur,4,"GURU, N.",Amma Makkal Munnettra Kazagam,1072,5,1077,0.5
Thiruvallur,5,"PASUPATHY, P.",Naam Tamilar Katchi,14943,85,15028,7.01
Thiruvallur,6,"KUMAR, E.",Independent,132,1,133,0.06
Thiruvallur,7,"SASIKUMAR, J.",Independent,87,0,87,0.04
Thiruvallur,8,"BALA KRISHNAN, N.",Independent,232,0,232,0.11
Thiruvallur,9,"RAMANAN, R.",Independent,97,0,97,0.05
Thiruvallur,10,"RAJENDIRAN, G.",Independent,385,3,388,0.18
Thiruvallur,11,"REVATHI, R.",Independent,281,2,283,0.13
Thiruvallur,12,NOTA,None of the Above,1857,15,1872,0.87
Thiruvarur,1,KALAIVANAN  POONDI  K.,Dravida Munnetra Kazhagam,107540,1366,108906,52.29
Thiruvarur,2,GOMATHI A.,Bahujan Samaj Party,716,4,720,0.35
Thiruvarur,3,PANNERSELVAM A.N.R.,All India Anna Dravida Munnetra Kazhagam,57439,293,57732,27.72
Thiruvarur,4,KABILARASAN  P.,Makkal Needhi Maiam,4034,34,4068,1.95
Thiruvarur,5,THIYAGASUNDARAM N.,Tamil Nadu Ilangyar Katchi,1000,8,1008,0.48
Thiruvarur,6,THIYAGARAJAN  M.,Puthiya Tamilagam,285,8,293,0.14
Thiruvarur,7,NASEEMA BANU M.A.,SOCIAL DEMOCRATIC PARTY OF INDIA,6348,16,6364,3.06
Thiruvarur,8,VINOTHINI R.,Naam Tamilar Katchi,26211,89,26300,12.63
Thiruvarur,9,AMANULLAH R.S.A.,Independent,163,0,163,0.08
Thiruvarur,10,ANBAZHAGAN T.,Independent,101,2,103,0.05
Thiruvarur,11,PANNEERSELVAM J.,Independent,530,1,531,0.25
Thiruvarur,12,MOHAMED HALITH A.,Independent,247,0,247,0.12
Thiruvarur,13,MUTHARASAN S.,Independent,200,2,202,0.1
Thiruvarur,14,NOTA,None of the Above,1646,7,1653,0.79
Thiruverumbur,1,ANBIL MAHESH POYYAMOZHI,Dravida Munnetra Kazhagam,103673,1751,105424,53.51
Thiruverumbur,2,P KUMAR,All India Anna Dravida Munnetra Kazhagam,55309,418,55727,28.29
Thiruverumbur,3,S.  SENTHILKUMAR,Desiya Murpokku Dravida Kazhagam,2260,33,2293,1.16
Thiruverumbur,4,MALATHI RAVICHANDRAN,Bahujan Samaj Party,225,1,226,0.11
Thiruverumbur,5,K.M. KARTHIK,Tamil Nadu Ilangyar Katchi,408,5,413,0.21
Thiruverumbur,6,S.SAKTHIVEL,New Generation People’s Party,414,2,416,0.21
Thiruverumbur,7,V CHOLASOORAN,Naam Tamilar Katchi,15628,91,15719,7.98
Thiruverumbur,8,K. PALANISAMY,Veerath Thiyagi Viswanathadoss Thozhilalarkal Katchi,122,1,123,0.06
Thiruverumbur,9,MURUGANANDAM M,Makkal Needhi Maiam,14547,131,14678,7.45
Thiruverumbur,10,S CHARLES,Independent,68,3,71,0.04
Thiruverumbur,11,R. PRIYA,Independent,72,0,72,0.04
Thiruverumbur,12,N. MUNIYANDI,Independent,52,2,54,0.03
Thiruverumbur,13,A. RAJA MOHAMED,Independent,67,0,67,0.03
Thiruverumbur,14,N. RAJU,Independent,88,0,88,0.04
Thiruverumbur,15,JESTIN RAJA,Independent,222,2,224,0.11
Thiruverumbur,16,NOTA,None of the Above,1403,15,1418,0.72
Thiruvidaimarudur,1,"CHEZHIAAN,  GOVI.",Dravida Munnetra Kazhagam,94602,1161,95763,48.26
Thiruvidaimarudur,2,"PURATCHI MANI, M.",Bahujan Samaj Party,1825,14,1839,0.93
Thiruvidaimarudur,3,"UNION VEERAMANI, S.",All India Anna Dravida Munnetra Kazhagam,84703,380,85083,42.87
Thiruvidaimarudur,4,"KANNAIYAN, T.",Communist Party of India  (Marxist-Leninist)  (Liberation),574,2,576,0.29
Thiruvidaimarudur,5,"KUDANTHAI ARASAN, J.",Amma Makkal Munnettra Kazagam,1736,10,1746,0.88
Thiruvidaimarudur,6,"SURESH, R.",Anaithu Makkal Puratchi Katchi,78,0,78,0.04
Thiruvidaimarudur,7,"DIVYA BHARATHI, M.",Naam Tamilar Katchi,11147,29,11176,5.63
Thiruvidaimarudur,8,"MADHANKUMAR, R.",Indiya Jananayaka Katchi,222,4,226,0.11
Thiruvidaimarudur,9,"KANNAIYAN, N.",Independent,62,6,68,0.03
Thiruvidaimarudur,10,"DHANASEKAR, V.",Independent,38,0,38,0.02
Thiruvidaimarudur,11,"NEDUMARAN, S.",Independent,66,2,68,0.03
Thiruvidaimarudur,12,"MATHI, M.",Independent,102,0,102,0.05
Thiruvidaimarudur,13,"MARIMUTHU, G.",Independent,245,0,245,0.12
Thiruvidaimarudur,14,"MARIYAPPAN, N.",Independent,198,0,198,0.1
Thiruvidaimarudur,15,NOTA,None of the Above,1233,7,1240,0.62
Thiruvottiyur,1,K.KUPPAN,All India Anna Dravida Munnetra Kazhagam,50435,89,50524,25.26
Thiruvottiyur,2,M.KOTTESWARAN,Bahujan Samaj Party,367,0,367,0.18
Thiruvottiyur,3,K.P.SHANKAR,Dravida Munnetra Kazhagam,87703,482,88185,44.09
Thiruvottiyur,4,R.EGAVALLI,Naadaalum Makkal Katchi,253,0,253,0.13
Thiruvottiyur,5,D.SASIRAJ,Samata Party,291,0,291,0.15
Thiruvottiyur,6,SEEMAN,Naam Tamilar Katchi,48497,100,48597,24.3
Thiruvottiyur,7,M.SOUNDARA PANDIAN,Amma Makkal Munnettra Kazagam,1413,4,1417,0.71
Thiruvottiyur,8,D.MOHAN,Makkal Needhi Maiam,7025,28,7053,3.53
Thiruvottiyur,9,K.GOPINATH,Independent,96,0,96,0.05
Thiruvottiyur,10,V.SURESHBALAJI,Independent,29,0,29,0.01
Thiruvottiyur,11,M.CHELLAM,Independent,184,0,184,0.09
Thiruvottiyur,12,D.THAMIZHIZHAN,Independent,103,0,103,0.05
Thiruvottiyur,13,B.DHANASEKARAN,Independent,88,0,88,0.04
Thiruvottiyur,14,C.DHANRAJ,Independent,115,0,115,0.06
Thiruvottiyur,15,PRAVINA,Independent,52,0,52,0.03
Thiruvottiyur,16,M.A.MICHAEL RAJ,Independent,601,2,603,0.3
Thiruvottiyur,17,N.RAMESH KUMAR,Independent,584,1,585,0.29
Thiruvottiyur,18,N.RAJESH KUMAR,Independent,48,0,48,0.02
Thiruvottiyur,19,U.VENKATESH,Independent,224,0,224,0.11
Thiruvottiyur,20,B.ZAKIR HUSSAIN,Independent,71,0,71,0.04
Thiruvottiyur,21,NOTA,None of the Above,1106,5,1111,0.56
Thiyagarayanagar,1,KARUNANITHI J,Dravida Munnetra Kazhagam,55465,570,56035,40.57
Thiyagarayanagar,2,SATHIYANAARAYANAN B,All India Anna Dravida Munnetra Kazhagam,55006,892,55898,40.47
Thiyagarayanagar,3,JOHNSON R,Bahujan Samaj Party,259,10,269,0.19
Thiyagarayanagar,4,ELLAPPAN A.K.D,Mahathma Makkal Munnetra Kazhakam,50,2,52,0.04
Thiyagarayanagar,5,KARUPPIAH PALA,Makkal Needhi Maiam,14473,94,14567,10.55
Thiyagarayanagar,6,SIVASANKARI S,Naam Tamilar Katchi,8259,25,8284,6
Thiyagarayanagar,7,DHANASEKARAN R,Desiya Makkal Sakthi Katchi,72,2,74,0.05
Thiyagarayanagar,8,DHANUSH M,United States of India Party,109,0,109,0.08
Thiyagarayanagar,9,THIRUNAVUKKARASU V,Makkalatchi Katchi,33,2,35,0.03
Thiyagarayanagar,10,BHARANEESWARAN R,Amma Makkal Munnettra Kazagam,774,8,782,0.57
Thiyagarayanagar,11,VETRI SELVI,Anaithu Makkal Arasiyal Katchi,79,9,88,0.06
Thiyagarayanagar,12,KANNAN S,Independent,86,2,88,0.06
Thiyagarayanagar,13,PALAYAN R,Independent,124,0,124,0.09
Thiyagarayanagar,14,RAJASEKARAN D,Independent,92,0,92,0.07
Thiyagarayanagar,15,NOTA,None of the Above,1597,20,1617,1.17
Thondamuthur,1,KARTHIKEYA,Dravida Munnetra Kazhagam,81829,766,82595,35.83
Thondamuthur,2,S.P. VELUMANI,All India Anna Dravida Munnetra Kazhagam,123538,687,124225,53.89
Thondamuthur,3,S. KALAIARASI,Naam Tamilar Katchi,8014,28,8042,3.49
Thondamuthur,4,R.SATHISHKUMAR,Amma Makkal Munnettra Kazagam,1229,6,1235,0.54
Thondamuthur,5,M. BADRAN,Ganasangam Party of India,136,0,136,0.06
Thondamuthur,6,S. SHAJAHAN,Makkal Needhi Maiam,11572,34,11606,5.03
Thondamuthur,7,A. ABDUL GAFOOR,Independent,141,1,142,0.06
Thondamuthur,8,CC SELVAMOHAN,Independent,173,2,175,0.08
Thondamuthur,9,A. MANSOOR ALI KHAN,Independent,426,2,428,0.19
Thondamuthur,10,J.JOHN EDWARD VISUVASAM,Independent,311,1,312,0.14
Thondamuthur,11,NOTA,None of the Above,1622,13,1635,0.71
Thoothukkudi,1,A.Ashok Kumar,Bahujan Samaj Party,432,4,436,0.23
Thoothukkudi,2,P.Geetha Jeevan,Dravida Munnetra Kazhagam,90206,2108,92314,49
Thoothukkudi,3,U.Chandran,Desiya Murpokku Dravida Kazhagam,4011,29,4040,2.14
Thoothukkudi,4,SDR Vijayaseelan,All India Anna Dravida Munnetra Kazhagam,41621,383,42004,22.29
Thoothukkudi,5,N.Sundar,Makkal Needhi Maiam,10475,59,10534,5.59
Thoothukkudi,6,S.Subash,Republican Party of India (Athawale),159,2,161,0.09
Thoothukkudi,7,K.Subramani,Shiv Sena,124,0,124,0.07
Thoothukkudi,8,G.Selvavinayagam,Veerath Thiyagi Viswanathadoss Thozhilalarkal Katchi,268,1,269,0.14
Thoothukkudi,9,N.Balasubramanian,Anna Puratchi Thalaivar Amma Dravida Munnetra Kazhagam,126,1,127,0.07
Thoothukkudi,10,Mannar Maharajan,Bahujan Dravida Party,93,0,93,0.05
Thoothukkudi,11,S.V.Rajasekar,United States of India Party,914,1,915,0.49
Thoothukkudi,12,V.Velraj,Naam Tamilar Katchi,30747,190,30937,16.42
Thoothukkudi,13,J.Arun Nehruraj,Independent,142,0,142,0.08
Thoothukkudi,14,J.Alldrin Airmarshal Thayaram,Independent,166,1,167,0.09
Thoothukkudi,15,C.Ganesh Ayyadurai,Independent,115,1,116,0.06
Thoothukkudi,16,S.Krishnan,Independent,182,0,182,0.1
Thoothukkudi,17,J.samuvel,Independent,138,0,138,0.07
Thoothukkudi,18,J.Sivaneswaran,Independent,2849,17,2866,1.52
Thoothukkudi,19,G.Selvam,Independent,75,0,75,0.04
Thoothukkudi,20,S.Balasundram,Independent,87,0,87,0.05
Thoothukkudi,21,L.Maria Deva Sahaya Johny,Independent,442,4,446,0.24
Thoothukkudi,22,A.Mohamed Imran Arabi,Independent,60,2,62,0.03
Thoothukkudi,23,Ramagunaseelan,Independent,88,0,88,0.05
Thoothukkudi,24,A.Rajavel,Independent,278,4,282,0.15
Thoothukkudi,25,M.Lingaraja,Independent,70,0,70,0.04
Thoothukkudi,26,A.Jeyalalitha,Independent,162,1,163,0.09
Thoothukkudi,27,NOTA,None of the Above,1539,30,1569,0.83
Thousand Lights,1,EZHILAN N,Dravida Munnetra Kazhagam,71437,430,71867,52.87
Thousand Lights,2,KUSHBOO SUNDAR,Bharatiya Janata Party,39237,168,39405,28.99
Thousand Lights,3,WILLIAMS D,Bahujan Samaj Party,245,1,246,0.18
Thousand Lights,4,K M SHARIFF,Makkal Needhi Maiam,11769,22,11791,8.67
Thousand Lights,5,DOMNIC A,Nam India Naam Indiyar Katchi,72,0,72,0.05
Thousand Lights,6,RIAZ(A) SYED ZAKEERULLA,Anaithu Makkal Arasiyal Katchi,52,0,52,0.04
Thousand Lights,7,VAIDHYANATHAN N,Amma Makkal Munnettra Kazagam,1145,10,1155,0.85
Thousand Lights,8,SHERINE AJ,Naam Tamilar Katchi,8860,24,8884,6.54
Thousand Lights,9,SANJEEVI S,Independent,66,0,66,0.05
Thousand Lights,10,SUDAKAR R,Independent,63,3,66,0.05
Thousand Lights,11,SEKAR K,Independent,30,1,31,0.02
Thousand Lights,12,DEEBAN M,Independent,37,0,37,0.03
Thousand Lights,13,NIRMAL KUMAR S,Independent,53,0,53,0.04
Thousand Lights,14,P PARIMALA,Independent,47,0,47,0.03
Thousand Lights,15,BABU A,Independent,65,0,65,0.05
Thousand Lights,16,PARTHIBAN V,Independent,154,0,154,0.11
Thousand Lights,17,MANIVANNAN N,Independent,229,0,229,0.17
Thousand Lights,18,RADHA KRISHNAN S,Independent,230,1,231,0.17
Thousand Lights,19,VELRAJ S,Independent,41,1,42,0.03
Thousand Lights,20,A GEORGE BENNY,Independent,62,0,62,0.05
Thousand Lights,21,NOTA,None of the Above,1381,4,1385,1.02
Thuraiyur,1,T.INDRAGANDHI,All India Anna Dravida Munnetra Kazhagam,65257,458,65715,37.36
Thuraiyur,2,S.ESWARAMOORTHY,Bahujan Samaj Party,865,2,867,0.49
Thuraiyur,3,S.STALINKUMAR,Dravida Munnetra Kazhagam,85802,1984,87786,49.91
Thuraiyur,4,K.GUNASEKARAN,Puthiya Tamilagam,539,2,541,0.31
Thuraiyur,5,K.SUBRAMANIAN,Amma Makkal Munnettra Kazagam,2404,31,2435,1.38
Thuraiyur,6,R.TAMILZHSELVI,Naam Tamilar Katchi,13074,84,13158,7.48
Thuraiyur,7,M.MALARMANNAN,Samaniya Makkal Nala Katchi,100,0,100,0.06
Thuraiyur,8,T.N. YUVARAJAN,Makkal Needhi Maiam,2489,39,2528,1.44
Thuraiyur,9,K.JAYAKKANNAN,Tamizhaga Murpokku Makkal Katchi,164,2,166,0.09
Thuraiyur,10,S.KARUPPIAH,Independent,314,6,320,0.18
Thuraiyur,11,A.SEERANGAN,Independent,119,0,119,0.07
Thuraiyur,12,SRINIVASAN J,Independent,316,1,317,0.18
Thuraiyur,13,K.SUNDARRAJ,Independent,230,0,230,0.13
Thuraiyur,14,NOTA,None of the Above,1580,14,1594,0.91
Tindivanam,1,ARJUNAN P,All India Anna Dravida Munnetra Kazhagam,86155,997,87152,47.74
Tindivanam,2,GOVINDASAMY A,Bahujan Samaj Party,599,4,603,0.33
Tindivanam,3,CHANDRALEKHA K,Desiya Murpokku Dravida Kazhagam,2678,23,2701,1.48
Tindivanam,4,SEETHAPATHY P,Dravida Munnetra Kazhagam,76038,1361,77399,42.4
Tindivanam,5,ILAVARASAN K,Anna Dravidar Kazhagam,424,0,424,0.23
Tindivanam,6,SETTU M,Desiya Sirupanmayinar Makkal Iyakkam,247,0,247,0.14
Tindivanam,7,PACHIMUTHU P,Naam Tamilar Katchi,9162,41,9203,5.04
Tindivanam,8,POYATHU @ ANBIN POYYAMOZHI S,Makkal Needhi Maiam,2068,11,2079,1.14
Tindivanam,9,MOHAN A,MAKKAL SAKTHI KATCHI,108,4,112,0.06
Tindivanam,10,VISWANATHAN S A,All  India  Pattali  Munnetra Katchi,148,0,148,0.08
Tindivanam,11,ARULMARAN J,Independent,120,2,122,0.07
Tindivanam,12,GOKULAKRISHNAN M,Independent,132,9,141,0.08
Tindivanam,13,THAMBIRAJ A,Independent,378,1,379,0.21
Tindivanam,14,VINOTH S,Independent,110,0,110,0.06
Tindivanam,15,VETRIVENDHAN S,Independent,195,0,195,0.11
Tindivanam,16,NOTA,None of the Above,1514,9,1523,0.83
Tiruchendur,1,Anitha R. Radhakrishnan,Dravida Munnetra Kazhagam,86162,2112,88274,50.58
Tiruchendur,2,Radhakrishnan M,All India Anna Dravida Munnetra Kazhagam,62420,591,63011,36.1
Tiruchendur,3,Gloriyan S,Naam Tamilar Katchi,14963,100,15063,8.63
Tiruchendur,4,Kennady Babu K,Veerath Thiyagi Viswanathadoss Thozhilalarkal Katchi,128,1,129,0.07
Tiruchendur,5,Rooswelt X,Naam Indiar Party,238,1,239,0.14
Tiruchendur,6,Vadamalaipandian S,Amma Makkal Munnettra Kazagam,3730,36,3766,2.16
Tiruchendur,7,Jayanthi M,Makkal Needhi Maiam,1949,16,1965,1.13
Tiruchendur,8,Arumugam S,Independent,107,1,108,0.06
Tiruchendur,9,Essakki Muthu,Independent,58,2,60,0.03
Tiruchendur,10,Kalyanasundaram R,Independent,90,2,92,0.05
Tiruchendur,11,Senthilkumar S,Independent,177,0,177,0.1
Tiruchendur,12,Shaik Abdul Kader P.S.J,Independent,136,0,136,0.08
Tiruchendur,13,Baskar C,Independent,195,1,196,0.11
Tiruchendur,14,Perumal K,Independent,73,0,73,0.04
Tiruchendur,15,Pon Rathna Selvan S,Independent,195,1,196,0.11
Tiruchendur,16,NOTA,None of the Above,1040,11,1051,0.6
Tiruchengodu,1,ESWARAN E R,Dravida Munnetra Kazhagam,79934,1754,81688,44.23
Tiruchengodu,2,SARASWATHI PON,All India Anna Dravida Munnetra Kazhagam,78010,816,78826,42.69
Tiruchengodu,3,KALAIVANAN A,My India Party,510,5,515,0.28
Tiruchengodu,4,SIVAKUMAR K,Tamilaga Makkal Thannurimai Katchi,203,1,204,0.11
Tiruchengodu,5,CHINNATHAMBI K,Republican Party of India (Athawale),75,0,75,0.04
Tiruchengodu,6,SENGOTTUVELLU N,Ahimsa Socialist Party,353,5,358,0.19
Tiruchengodu,7,NATARAJAN P,Naam Tamilar Katchi,13857,110,13967,7.56
Tiruchengodu,8,YUVARAJKUMAR K,Namathu Kongu Munnetra Kalagam,100,0,100,0.05
Tiruchengodu,9,JANAGARAJ R,Makkal Needhi Maiam,3695,29,3724,2.02
Tiruchengodu,10,HEMALATHA R,Amma Makkal Munnettra Kazagam,446,3,449,0.24
Tiruchengodu,11,ESWARAN A,Independent,52,0,52,0.03
Tiruchengodu,12,ESWARAN K,Independent,57,4,61,0.03
Tiruchengodu,13,ESWARAN G,Independent,48,1,49,0.03
Tiruchengodu,14,ESWARAN M,Independent,325,1,326,0.18
Tiruchengodu,15,KARTHIKEYAN S,Independent,373,2,375,0.2
Tiruchengodu,16,SHANMUGASUNDARAM T,Independent,665,1,666,0.36
Tiruchengodu,17,SATHIESHKUMAR C,Independent,391,0,391,0.21
Tiruchengodu,18,CHANDRA R,Independent,210,0,210,0.11
Tiruchengodu,19,SARAVANAN K,Independent,43,0,43,0.02
Tiruchengodu,20,SARASWATHI M,Independent,71,5,76,0.04
Tiruchengodu,21,SENTHILKUMAR C,Independent,24,1,25,0.01
Tiruchengodu,22,SELVARAMLINGAM,Independent,196,4,200,0.11
Tiruchengodu,23,SELVARAJ K R,Independent,62,0,62,0.03
Tiruchengodu,24,BALAMURUGAN C,Independent,378,1,379,0.21
Tiruchengodu,25,BALAMURUGAN S,Independent,52,1,53,0.03
Tiruchengodu,26,BALAJICHEZHIAN P,Independent,54,0,54,0.03
Tiruchengodu,27,RANJIT R,Independent,93,3,96,0.05
Tiruchengodu,28,VELU K,Independent,126,1,127,0.07
Tiruchengodu,29,NOTA,None of the Above,1506,12,1518,0.82
Tiruchirappalli (East),1,"INIGO IRUDAYARAJ,S.",Dravida Munnetra Kazhagam,92645,1657,94302,54.56
Tiruchirappalli (East),2,"VELLAMANDI NATARAJAN,N.",All India Anna Dravida Munnetra Kazhagam,40109,396,40505,23.43
Tiruchirappalli (East),3,"PRABU,R.",Naam Tamilar Katchi,14211,101,14312,8.28
Tiruchirappalli (East),4,MANOHARAN.R.,Amma Makkal Munnettra Kazagam,9010,79,9089,5.26
Tiruchirappalli (East),5,VIJAIA MOHANAAJI,Vidial Valarchi Perani,105,0,105,0.06
Tiruchirappalli (East),6,"VEERASAKTHI,D.",Makkal Needhi Maiam,11309,87,11396,6.59
Tiruchirappalli (East),7,"ARAVINDAN,P.",Independent,85,0,85,0.05
Tiruchirappalli (East),8,"AROCKIA SATHEESH,A.",Independent,69,1,70,0.04
Tiruchirappalli (East),9,"IRUDAYARAJ,S.",Independent,55,3,58,0.03
Tiruchirappalli (East),10,"GASPAR REGAN,S.",Independent,49,1,50,0.03
Tiruchirappalli (East),11,"CHARLES SAGAYARAJ,P.",Independent,69,4,73,0.04
Tiruchirappalli (East),12,"DEVAKUMAR,T.",Independent,72,1,73,0.04
Tiruchirappalli (East),13,"BALAMURUGAN,A.",Independent,211,0,211,0.12
Tiruchirappalli (East),14,"MARUTHAMUTHU,N.",Independent,45,1,46,0.03
Tiruchirappalli (East),15,"MANOHARAN,M.",Independent,157,0,157,0.09
Tiruchirappalli (East),16,"RAJA,S.",Independent,381,1,382,0.22
Tiruchirappalli (East),17,"JAHIR HUSSAIN,M.",Independent,207,1,208,0.12
Tiruchirappalli (East),18,"SHEIK ABDULLAH,R.",Independent,199,0,199,0.12
Tiruchirappalli (East),19,NOTA,None of the Above,1504,31,1535,0.89
Tiruchirappalli (West),1,"Nehru, K.N.",Dravida Munnetra Kazhagam,116018,2115,118133,64.52
Tiruchirappalli (West),2,"Padmanathan, V.",All India Anna Dravida Munnetra Kazhagam,32632,392,33024,18.04
Tiruchirappalli (West),3,"Abubacker Siddiq,  M.",Makkal Needhi Maiam,10466,80,10546,5.76
Tiruchirappalli (West),4,"Abdullah Hassan Faizy, R.",SOCIAL DEMOCRATIC PARTY OF INDIA,2525,20,2545,1.39
Tiruchirappalli (West),5,"Vinodh, V.",Naam Tamilar Katchi,15637,88,15725,8.59
Tiruchirappalli (West),6,"Kalpana, T.",Independent,193,3,196,0.11
Tiruchirappalli (West),7,"Sahabudheen, A.J.",Independent,41,2,43,0.02
Tiruchirappalli (West),8,"Sudha, R.",Independent,216,6,222,0.12
Tiruchirappalli (West),9,"Sundar Rajulu, G.",Independent,40,2,42,0.02
Tiruchirappalli (West),10,"Selvaraj, D.",Independent,48,0,48,0.03
Tiruchirappalli (West),11,"Dheepan, M.",Independent,65,1,66,0.04
Tiruchirappalli (West),12,"Vasudevan, A.",Independent,211,0,211,0.12
Tiruchirappalli (West),13,"Shajahan, R.",Independent,181,0,181,0.1
Tiruchirappalli (West),14,NOTA,None of the Above,2079,38,2117,1.16
Tiruchuli,1,THANGAM THENARASU,Dravida Munnetra Kazhagam,101016,1209,102225,59.15
Tiruchuli,2,RAJASEKAR S,All India Anna Dravida Munnetra Kazhagam,41087,146,41233,23.86
Tiruchuli,3,ANANDHAJOTHI A,Naam Tamilar Katchi,13654,133,13787,7.98
Tiruchuli,4,SIVASAMY K K,Amma Makkal Munnettra Kazagam,6399,42,6441,3.73
Tiruchuli,5,THIRUMURUGAN PALANISAMY K,Puthiya Tamilagam,586,7,593,0.34
Tiruchuli,6,MANIVASAGAM S,Bahujan Dravida Party,70,0,70,0.04
Tiruchuli,7,MURUGAN S,Makkal Needhi Maiam,1338,18,1356,0.78
Tiruchuli,8,ADAIKALAM R,Independent,896,2,898,0.52
Tiruchuli,9,ARUNKUMAR V,Independent,2491,1,2492,1.44
Tiruchuli,10,INDIRA B,Independent,123,1,124,0.07
Tiruchuli,11,KALIMUTHU S,Independent,46,0,46,0.03
Tiruchuli,12,CHENNAKESAVAN P,Independent,52,0,52,0.03
Tiruchuli,13,SETHURAMALINGAM S,Independent,65,0,65,0.04
Tiruchuli,14,ADVOCATE. THANGAPANDIAN M,Independent,357,8,365,0.21
Tiruchuli,15,THIRUMURUGAN G,Independent,480,0,480,0.28
Tiruchuli,16,MALAIALAGU M,Independent,566,0,566,0.33
Tiruchuli,17,RAMATHILAGAM A,Independent,683,1,684,0.4
Tiruchuli,18,RAJANGAM C,Independent,349,0,349,0.2
Tiruchuli,19,RAJENDRAN R,Independent,137,0,137,0.08
Tiruchuli,20,HARIKRISHNAN K,Independent,108,0,108,0.06
Tiruchuli,21,NOTA,None of the Above,734,6,740,0.43
Tirukkoyilur,1,VAT.KALIVARADHAN,Bharatiya Janata Party,50887,413,51300,26.14
Tirukkoyilur,2,SIVA.PANJAVARNAM,Bahujan Samaj Party,691,5,696,0.35
Tirukkoyilur,3,K.PONMUDY,Dravida Munnetra Kazhagam,109226,1754,110980,56.56
Tirukkoyilur,4,L.VENKATESAN,Desiya Murpokku Dravida Kazhagam,13928,69,13997,7.13
Tirukkoyilur,5,SANKAR S,Veerath Thiyagi Viswanathadoss Thozhilalarkal Katchi,565,1,566,0.29
Tirukkoyilur,6,SENTHILKUMAR M,Indiya Jananayaka Katchi,1056,10,1066,0.54
Tirukkoyilur,7,MURUGAN S,Naam Tamilar Katchi,11567,53,11620,5.92
Tirukkoyilur,8,RAJINI VR,Naadaalum Makkal Katchi,231,0,231,0.12
Tirukkoyilur,9,KATHIRAVAN K,Independent,183,6,189,0.1
Tirukkoyilur,10,PRAKASH A,Independent,881,2,883,0.45
Tirukkoyilur,11,MAGESH M,Independent,271,5,276,0.14
Tirukkoyilur,12,MATHIVANAN S,Independent,412,0,412,0.21
Tirukkoyilur,13,VIGNESH M,Independent,1482,0,1482,0.76
Tirukkoyilur,14,JAYAVINDAN G,Independent,480,0,480,0.24
Tirukkoyilur,15,NOTA,None of the Above,2030,9,2039,1.04
Tirunelveli,1,Kalanithy,Bahujan Samaj Party,646,8,654,0.33
Tirunelveli,2,Nainar Nagenthran,Bharatiya Janata Party,91504,778,92282,46.7
Tirunelveli,3,"Lakshmanan,A.L.S.",Dravida Munnetra Kazhagam,68102,1073,69175,35.01
Tirunelveli,4,"Sathya,B.",Naam Tamilar Katchi,18986,176,19162,9.7
Tirunelveli,5,"Sundarraj,M.",Communist Party of India  (Marxist-Leninist)  (Liberation),412,3,415,0.21
Tirunelveli,6,"Mahesh Kannan,A.P.",Amma Makkal Munnettra Kazagam,8807,104,8911,4.51
Tirunelveli,7,"Esakkimuthu,P.",Independent,435,2,437,0.22
Tirunelveli,8,"Sankarasubramanian,M.",Independent,582,0,582,0.29
Tirunelveli,9,Sankar @ Sankaranarayanan,Independent,264,0,264,0.13
Tirunelveli,10,"Sivakumar,M.",Independent,1375,37,1412,0.71
Tirunelveli,11,"Murugan,R.",Independent,197,2,199,0.1
Tirunelveli,12,"Murugan,V.",Independent,339,3,342,0.17
Tirunelveli,13,"Raghavan,C.M.",Independent,318,1,319,0.16
Tirunelveli,14,Srithar Rajan,Independent,1336,6,1342,0.68
Tirunelveli,15,NOTA,None of the Above,2074,17,2091,1.06
Tirupattur,1,A. NALLATHAMBI,Dravida Munnetra Kazhagam,95067,1455,96522,51.91
Tirupattur,2,S. KALASHTHRI,All India Uzhavargal Uzhaippalargal Katchi,713,11,724,0.39
Tirupattur,3,S. SATHIYAMOORTHY,Makkal Nala Kazhagam,516,3,519,0.28
Tirupattur,4,M. SUMATHI,Naam Tamilar Katchi,12016,111,12127,6.52
Tirupattur,5,A. GNANASEKAR,Amma Makkal Munnettra Kazagam,2679,23,2702,1.45
Tirupattur,6,T.K. RAJA,Pattali Makkal Katchi,67905,377,68282,36.72
Tirupattur,7,I. ROSELIN JEEVA,Samaniya Makkal Nala Katchi,263,1,264,0.14
Tirupattur,8,A. JEYAMMA,Anaithu Makkal Puratchi Katchi,127,1,128,0.07
Tirupattur,9,R. AROCKIA JOE PRABU,Independent,437,1,438,0.24
Tirupattur,10,I. GOVINDARAJI,Independent,296,1,297,0.16
Tirupattur,11,M. NALLASIVAM,Independent,322,1,323,0.17
Tirupattur,12,R. PALANI,Independent,361,1,362,0.19
Tirupattur,13,MANITHAN,Independent,308,1,309,0.17
Tirupattur,14,G. RAJA,Independent,204,1,205,0.11
Tirupattur,15,B. VIJAYAKUMAR,Independent,1091,5,1096,0.59
Tirupattur,16,NOTA,None of the Above,1625,7,1632,0.88
Tiruppattur,1,MARUDHU ALAGURAJ,All India Anna Dravida Munnetra Kazhagam,65915,393,66308,31.46
Tiruppattur,2,KR.PERIYAKARUPPAN,Dravida Munnetra Kazhagam,102261,1421,103682,49.19
Tiruppattur,3,A.AMALAN SAVARIMUTHU,Indiya Jananayaka Katchi,856,6,862,0.41
Tiruppattur,4,K.K.UMADHEVAN,Amma Makkal Munnettra Kazagam,7396,52,7448,3.53
Tiruppattur,5,KOTTAIKUMAR,Naam Tamilar Katchi,14518,53,14571,6.91
Tiruppattur,6,M.SARASWATHI,Puthiya Tamilagam,240,1,241,0.11
Tiruppattur,7,S.MURUGAN,Anaithu Makkal Puratchi Katchi,95,1,96,0.05
Tiruppattur,8,K.VEERAPANDIAN,My India Party,143,1,144,0.07
Tiruppattur,9,G.ABDUL KISHORE BABU,Independent,84,1,85,0.04
Tiruppattur,10,ANANDHAN K,Independent,62,0,62,0.03
Tiruppattur,11,C.KANNAN,Independent,67,1,68,0.03
Tiruppattur,12,A.KARTHIKA,Independent,80,0,80,0.04
Tiruppattur,13,P.SELVARAJ,Independent,221,0,221,0.1
Tiruppattur,14,C.PARAMASIVAM,Independent,13186,16,13202,6.26
Tiruppattur,15,PALANIAPPAN,Independent,333,0,333,0.16
Tiruppattur,16,A.PARTHASARATHY,Independent,465,0,465,0.22
Tiruppattur,17,PERIYASAMY,Independent,604,1,605,0.29
Tiruppattur,18,A.MALLIKA,Independent,444,0,444,0.21
Tiruppattur,19,M.MOHAMED RABEEK,Independent,122,0,122,0.06
Tiruppattur,20,MUTHULAKSHMI,Independent,65,0,65,0.03
Tiruppattur,21,RM.MURUGESAN,Independent,69,0,69,0.03
Tiruppattur,22,K.S.K.RAJESH,Independent,352,0,352,0.17
Tiruppattur,23,P.RAJESWARI,Independent,152,0,152,0.07
Tiruppattur,24,RENUKA,Independent,56,0,56,0.03
Tiruppattur,25,J.VEERAYI,Independent,65,0,65,0.03
Tiruppattur,26,P.JEYACHANDRAN,Independent,115,0,115,0.05
Tiruppattur,27,NOTA,None of the Above,845,8,853,0.4
Tiruppur (North),1,CHANDRASEKARAN.R,Bahujan Samaj Party,474,3,477,0.2
Tiruppur (North),2,RAVI (Alias) SUBRAMANIAN . M,Communist Party of India,72679,603,73282,30.78
Tiruppur (North),3,SELVAKUMAR.M,Desiya Murpokku Dravida Kazhagam,3420,7,3427,1.44
Tiruppur (North),4,VIJEYAKUMAR.K.N,All India Anna Dravida Munnetra Kazhagam,113119,265,113384,47.62
Tiruppur (North),5,ALAGHUSUNDARAM.P,Anna Dravidar Kazhagam,591,1,592,0.25
Tiruppur (North),6,EASWARAN.S,Naam Tamilar Katchi,23061,49,23110,9.71
Tiruppur (North),7,SIVABALAN.S,Makkal Needhi Maiam,19565,37,19602,8.23
Tiruppur (North),8,SENTHILKUMAR.V,Anna Puratchi Thalaivar Amma Dravida Munnetra Kazhagam,426,2,428,0.18
Tiruppur (North),9,DEIVASIGAMANI.K,Ezhuchi Tamilargal Munnetra Kazhagam,139,0,139,0.06
Tiruppur (North),10,UDHAYAKUMAR.S,Independent,337,5,342,0.14
Tiruppur (North),11,SENTHILKUMAR.T.N,Independent,96,0,96,0.04
Tiruppur (North),12,SENTHILKUMAR.R,Independent,131,2,133,0.06
Tiruppur (North),13,SENTHILVEL.A,Independent,301,1,302,0.13
Tiruppur (North),14,MURUGA PANDI.S,Independent,249,1,250,0.11
Tiruppur (North),15,RANGASAMY.M,Independent,365,1,366,0.15
Tiruppur (North),16,NOTA,None of the Above,2154,8,2162,0.91
Tiruppur (South),1,GUNASEKARAN. S.,All India Anna Dravida Munnetra Kazhagam,70551,275,70826,40.61
Tiruppur (South),2,CHELLAPANDY. P.,Bahujan Samaj Party,311,1,312,0.18
Tiruppur (South),3,SELVARAJ. K.,Dravida Munnetra Kazhagam,74944,591,75535,43.31
Tiruppur (South),4,ARUNKUMAR. G.,Tamil Nadu Ilangyar Katchi,554,0,554,0.32
Tiruppur (South),5,ANUSHA RAVI.,Makkal Needhi Maiam,9914,20,9934,5.7
Tiruppur (South),6,SHANMUGASUNDARAM. K.,Naam Tamilar Katchi,12870,28,12898,7.39
Tiruppur (South),7,DEIVEEGAN. K.,Anna Puratchi Thalaivar Amma Dravida Munnetra Kazhagam,101,0,101,0.06
Tiruppur (South),8,VISHALAKCHI. A.,Amma Makkal Munnettra Kazagam,1751,6,1757,1.01
Tiruppur (South),9,ASLAM. J.,Independent,163,1,164,0.09
Tiruppur (South),10,GANESH. E.,Independent,66,0,66,0.04
Tiruppur (South),11,KADER BASHA. A.,Independent,75,1,76,0.04
Tiruppur (South),12,GUNASEKARAN. I.,Independent,38,0,38,0.02
Tiruppur (South),13,GUNASEKARAN. M.,Independent,80,0,80,0.05
Tiruppur (South),14,SARVALOGA DAYABARAN. M.A.,Independent,147,0,147,0.08
Tiruppur (South),15,SELVARAJ. A.,Independent,68,0,68,0.04
Tiruppur (South),16,SELVAN. K.,Independent,224,0,224,0.13
Tiruppur (South),17,PRAKASH. R.,Independent,264,1,265,0.15
Tiruppur (South),18,MALARVIZHI. G.,Independent,83,0,83,0.05
Tiruppur (South),19,MUTHUSAMY. K.,Independent,121,0,121,0.07
Tiruppur (South),20,VIJAYAKUMAR. A.,Independent,27,0,27,0.02
Tiruppur (South),21,NOTA,None of the Above,1133,9,1142,0.65
Tiruttani,1,G.Hari,All India Anna Dravida Munnetra Kazhagam,89704,1357,91061,39.15
Tiruttani,2,D.Krishnamoorthi,Desiya Murpokku Dravida Kazhagam,3903,25,3928,1.69
Tiruttani,3,S.Chandran,Dravida Munnetra Kazhagam,118005,2309,120314,51.72
Tiruttani,4,N.MAGENDIRAN,Bahujan Samaj Party,711,6,717,0.31
Tiruttani,5,L.AKILA,Naam Tamilar Katchi,11900,107,12007,5.16
Tiruttani,6,M.D.Thanigai Malai,Indiya Jananayaka Katchi,352,1,353,0.15
Tiruttani,7,Manikkam,All India Jananayaka Makkal Kazhagam,121,0,121,0.05
Tiruttani,8,M.Hari,Independent,365,1,366,0.16
Tiruttani,9,Chandran,Independent,59,1,60,0.03
Tiruttani,10,Chandran,Independent,46,0,46,0.02
Tiruttani,11,A.J.Suresh,Independent,174,8,182,0.08
Tiruttani,12,Shettu,Independent,147,0,147,0.06
Tiruttani,13,D.PAULRAJ,Independent,886,3,889,0.38
Tiruttani,14,V.P.Vijayan,Independent,760,8,768,0.33
Tiruttani,15,NOTA,None of the Above,1653,12,1665,0.72
Tiruvadanai,1,ANBUBAGURUDEEN N,Nationalist Congress Party,621,8,629,0.31
Tiruvadanai,2,K C ANIMUTHU,All India Anna Dravida Munnetra Kazhagam,65049,463,65512,32.46
Tiruvadanai,3,KARUMANICKAM,Indian National Congress,78415,949,79364,39.33
Tiruvadanai,4,RAMALINGAM,Bahujan Samaj Party,605,5,610,0.3
Tiruvadanai,5,ANANDH N,Amma Makkal Munnettra Kazagam,33038,388,33426,16.56
Tiruvadanai,6,ANANTHARAJ S,My India Party,399,0,399,0.2
Tiruvadanai,7,SATHYARAJ,Makkal Needhi Maiam,2189,19,2208,1.09
Tiruvadanai,8,JAWAHAR,Naam Tamilar Katchi,16403,98,16501,8.18
Tiruvadanai,9,SIKKANDAR,Independent,262,0,262,0.13
Tiruvadanai,10,SURIYA PRAKASH,Independent,385,0,385,0.19
Tiruvadanai,11,PRADEEP,Independent,163,0,163,0.08
Tiruvadanai,12,PRAVEEN,Independent,273,1,274,0.14
Tiruvadanai,13,PERUMAL,Independent,517,5,522,0.26
Tiruvadanai,14,MANI,Independent,382,0,382,0.19
Tiruvadanai,15,MANIKANDAN,Independent,410,0,410,0.2
Tiruvadanai,16,NOTA,None of the Above,765,3,768,0.38
Tiruvannamalai,1,KOTHANDAPANI,Bahujan Samaj Party,460,6,466,0.22
Tiruvannamalai,2,S THANIGAIVEL,Bharatiya Janata Party,42836,367,43203,20.69
Tiruvannamalai,3,E V VELU,Dravida Munnetra Kazhagam,134987,2889,137876,66.02
Tiruvannamalai,4,J AGNI SELVARASU,Naadaalum Makkal Katchi,545,3,548,0.26
Tiruvannamalai,5,ARUL R,Makkal Needhi Maiam,6169,77,6246,2.99
Tiruvannamalai,6,J KAMALAKKANNAN,Naam Tamilar Katchi,13894,101,13995,6.7
Tiruvannamalai,7,R CHANDRAKANTH PILLAI,New Generation People’s Party,98,3,101,0.05
Tiruvannamalai,8,S K SELVAM,Veerath Thiyagi Viswanathadoss Thozhilalarkal Katchi,130,1,131,0.06
Tiruvannamalai,9,A G PANCHATCHARAM,Amma Makkal Munnettra Kazagam,2088,20,2108,1.01
Tiruvannamalai,10,A NAKKEERAN,Independent,142,4,146,0.07
Tiruvannamalai,11,N PALANI,Independent,145,19,164,0.08
Tiruvannamalai,12,D MANIMARAN,Independent,152,5,157,0.08
Tiruvannamalai,13,R G VASUDEVAN,Independent,291,0,291,0.14
Tiruvannamalai,14,K VINAYAGAM,Independent,430,0,430,0.21
Tiruvannamalai,15,J JAMEEL BASHA,Independent,774,6,780,0.37
Tiruvannamalai,16,NOTA,None of the Above,2170,24,2194,1.05
Tittakudi,1,"UMANATH,  R.",Desiya Murpokku Dravida Kazhagam,4121,21,4142,2.46
Tittakudi,2,"GANESAN,  C.V.",Dravida Munnetra Kazhagam,82780,946,83726,49.78
Tittakudi,3,"PERIYASAMY,  D.",Bharatiya Janata Party,61851,312,62163,36.96
Tittakudi,4,"RAVICHANDRAN,  P.",Bahujan Samaj Party,558,1,559,0.33
Tittakudi,5,"ARULDOSS,  E.",Desiya Makkal Sakthi Katchi,219,2,221,0.13
Tittakudi,6,"KAMATCHI,  N.",Naam Tamilar Katchi,10555,36,10591,6.3
Tittakudi,7,"PRABAKARAN,  R.",Makkal Needhi Maiam,1730,15,1745,1.04
Tittakudi,8,"AYYASAMY,  S.",Independent,720,4,724,0.43
Tittakudi,9,"KARUPPAN,  M.",Independent,927,17,944,0.56
Tittakudi,10,"KAMARAJ,  K.",Independent,141,0,141,0.08
Tittakudi,11,"KOLANJINATHAN,  V.",Independent,129,1,130,0.08
Tittakudi,12,"SEENUVASAN,  C.",Independent,197,0,197,0.12
Tittakudi,13,"SUMATHI,  S.",Independent,237,1,238,0.14
Tittakudi,14,"NATARAJAN,  M.",Independent,1063,0,1063,0.63
Tittakudi,15,"PALANIAMMAL,  P.",Independent,601,0,601,0.36
Tittakudi,16,NOTA,None of the Above,995,4,999,0.59
Udhagamandalam,1,"GANESH, R.",Indian National Congress,64148,1382,65530,46.44
Udhagamandalam,2,"BHOJARAJAN, M.",Bharatiya Janata Party,59553,629,60182,42.65
Udhagamandalam,3,"Dr.SURESH BABU, S.",Makkal Needhi Maiam,4859,76,4935,3.5
Udhagamandalam,4,"LAKSHMANAN, T.",Amma Makkal Munnettra Kazagam,1250,23,1273,0.9
Udhagamandalam,5,"JAYAKUMAR, A.",Naam Tamilar Katchi,6316,65,6381,4.52
Udhagamandalam,6,"AROKIYANATHAN, B.",Independent,514,0,514,0.36
Udhagamandalam,7,"KRISHNAMURTHI, B.",Independent,249,6,255,0.18
Udhagamandalam,8,"A. SARDAR BABU, B.COM.",Independent,223,2,225,0.16
Udhagamandalam,9,"VINOTHKUMAR, M.A.",Independent,425,6,431,0.31
Udhagamandalam,10,NOTA,None of the Above,1357,19,1376,0.98
Udumalaipettai,1,"Kumar,K.",Bahujan Samaj Party,456,3,459,0.24
Udumalaipettai,2,"Thennarasu,K.",Indian National Congress,73788,1210,74998,38.59
Udumalaipettai,3,"Radhakrishnan,K.",All India Anna Dravida Munnetra Kazhagam,95953,940,96893,49.85
Udumalaipettai,4,"Krishnan,T.",Anna Puratchi Thalaivar Amma Dravida Munnetra Kazhagam,680,3,683,0.35
Udumalaipettai,5,"Nachammal,K.",Anaithu Makkal Arasiyal Katchi,175,2,177,0.09
Udumalaipettai,6,"Palanisamy,R.",Amma Makkal Munnettra Kazagam,1038,5,1043,0.54
Udumalaipettai,7,"Babu Ranjendra Prasad,A.",Naam Tamilar Katchi,8540,52,8592,4.42
Udumalaipettai,8,"Srinithi,V.",Makkal Needhi Maiam,8107,56,8163,4.2
Udumalaipettai,9,"Ashokkumar,S.",Independent,70,0,70,0.04
Udumalaipettai,10,"Arumugam,P.",Independent,182,2,184,0.09
Udumalaipettai,11,"Umar Ali,D.",Independent,217,7,224,0.12
Udumalaipettai,12,"Elsy,C.",Independent,124,2,126,0.06
Udumalaipettai,13,"Karthikeyan,S.",Independent,180,1,181,0.09
Udumalaipettai,14,"Dhivya,D.",Independent,785,2,787,0.4
Udumalaipettai,15,"Rajini,K.",Independent,300,0,300,0.15
Udumalaipettai,16,NOTA,None of the Above,1469,9,1478,0.76
Ulundurpettai,1,KUMARAGURU R,All India Anna Dravida Munnetra Kazhagam,108960,1235,110195,45
Ulundurpettai,2,SATHIYAMOORTHY,Bahujan Samaj Party,823,2,825,0.34
Ulundurpettai,3,MANIKANNAN A J,Dravida Munnetra Kazhagam,114344,1107,115451,47.15
Ulundurpettai,4,K.G.P.Rajamani,Amma Makkal Munnettra Kazagam,2843,5,2848,1.16
Ulundurpettai,5,KUMAR A,Indhia Kudiarasu Katchi,110,0,110,0.04
Ulundurpettai,6,CHINNAIYAN S,Makkal Needhi Maiam,673,4,677,0.28
Ulundurpettai,7,DHANAPAL P,Lok Jan Shakti Party,81,0,81,0.03
Ulundurpettai,8,Pushbamary L,Naam Tamilar Katchi,8954,46,9000,3.68
Ulundurpettai,9,VENkATESAN M,Communist Party of India  (Marxist-Leninist)  (Liberation),140,3,143,0.06
Ulundurpettai,10,RAJAMANI  K,Independent,116,1,117,0.05
Ulundurpettai,11,KATHIRVEL M,Independent,102,3,105,0.04
Ulundurpettai,12,DEEPA,My India Party,263,0,263,0.11
Ulundurpettai,13,MANI R,Veerath Thiyagi Viswanathadoss Thozhilalarkal Katchi,298,1,299,0.12
Ulundurpettai,14,MANIKANNAN M,Independent,2106,1,2107,0.86
Ulundurpettai,15,RAJASTALIN K,Independent,351,1,352,0.14
Ulundurpettai,16,NOTA,None of the Above,2277,3,2280,0.93
Usilampatti,1,AYYAPPAN P,All India Anna Dravida Munnetra Kazhagam,70780,475,71255,33.53
Usilampatti,2,KATHIRAVAN P V,Dravida Munnetra Kazhagam,62877,901,63778,30.01
Usilampatti,3,ARASUMAYAN M,All India Jananayaka Makkal Kazhagam,961,6,967,0.46
Usilampatti,4,IYNDHUKOVILAN G,Naam Tamilar Katchi,15089,268,15357,7.23
Usilampatti,5,THIRUSELVAM C,Puthiya Tamilagam,1149,12,1161,0.55
Usilampatti,6,BHARATH V,My India Party,372,6,378,0.18
Usilampatti,7,MAHENDRAN I,Amma Makkal Munnettra Kazagam,54758,733,55491,26.11
Usilampatti,8,ARUNKUMAR M,Independent,359,3,362,0.17
Usilampatti,9,ALAGUMURUGESAN K,Independent,155,3,158,0.07
Usilampatti,10,ARUMUGAM K,Independent,1238,9,1247,0.59
Usilampatti,11,ANANTHA KUMAR N,Independent,69,5,74,0.03
Usilampatti,12,KATHIRAVAN A,Independent,523,5,528,0.25
Usilampatti,13,Dhanasekaran T,Independent,477,1,478,0.22
Usilampatti,14,MAHENDRAN A,Independent,247,0,247,0.12
Usilampatti,15,NOTA,None of the Above,1015,17,1032,0.49
Uthangarai,1,S.Arumugam,Indian National Congress,70084,1204,71288,37.87
Uthangarai,2,T.M.TAMILSELVAM,All India Anna Dravida Munnetra Kazhagam,98973,702,99675,52.96
Uthangarai,3,NAGARAJ,Bahujan Samaj Party,718,4,722,0.38
Uthangarai,4,R.Bakyaraj,Desiya Murpokku Dravida Kazhagam,2278,13,2291,1.22
Uthangarai,5,Elangovan,Naam Tamilar Katchi,10352,72,10424,5.54
Uthangarai,6,S.Perumal,Anna Puratchi Thalaivar Amma Dravida Munnetra Kazhagam,205,1,206,0.11
Uthangarai,7,K.Murugesan,Makkal Needhi Maiam,1239,15,1254,0.67
Uthangarai,8,T.Tamilarasan,Independent,180,1,181,0.1
Uthangarai,9,M.Thenmozhi,Independent,103,1,104,0.06
Uthangarai,10,R.Manjunathan,Independent,112,2,114,0.06
Uthangarai,11,R.Vivekanandhan,Independent,280,3,283,0.15
Uthangarai,12,C.Jayaraman,Independent,322,0,322,0.17
Uthangarai,13,NOTA,None of the Above,1354,5,1359,0.72
Uthiramerur,1,SUNDAR K,Dravida Munnetra Kazhagam,92161,1266,93427,44.38
Uthiramerur,2,SURESH D,Bahujan Samaj Party,600,2,602,0.29
Uthiramerur,3,SOMASUNDARAM V,All India Anna Dravida Munnetra Kazhagam,91127,678,91805,43.61
Uthiramerur,4,KAMACTHI.S,Naam Tamilar Katchi,11320,85,11405,5.42
Uthiramerur,5,SIVAKUMAR.A,Desiya Makkal Sakthi Katchi,134,2,136,0.06
Uthiramerur,6,SUSAIAPPAR.A,Makkal Needhi Maiam,2077,23,2100,1
Uthiramerur,7,RANJITHKUMAR.R.V,Amma Makkal Munnettra Kazagam,7181,30,7211,3.43
Uthiramerur,8,JAISUDHA.V,Republican Party of India (Athawale),82,3,85,0.04
Uthiramerur,9,AROKIASAMY.J,Independent,91,13,104,0.05
Uthiramerur,10,GUNASEKAR.V,Independent,104,0,104,0.05
Uthiramerur,11,SARAVANAN.A,Independent,298,6,304,0.14
Uthiramerur,12,SIVALINGAM.M,Independent,64,0,64,0.03
Uthiramerur,13,CHINNASWAMY.T,Independent,100,1,101,0.05
Uthiramerur,14,THANGARAJ.K,Independent,332,1,333,0.16
Uthiramerur,15,DEVARAJAN.C,Independent,140,1,141,0.07
Uthiramerur,16,PONNAMBALAM.R,Independent,752,1,753,0.36
Uthiramerur,17,MADHAVARAJ.K.V,Independent,448,0,448,0.21
Uthiramerur,18,JEEVANANTHAM.D,Independent,66,0,66,0.03
Uthiramerur,19,JAYABALAN.E,Independent,305,1,306,0.15
Uthiramerur,20,JAYARAMAN.C.A,Independent,81,1,82,0.04
Uthiramerur,21,NOTA,None of the Above,946,6,952,0.45
Valparai,1,AMULKANDASAMI T K,All India Anna Dravida Munnetra Kazhagam,71128,544,71672,49.37
Valparai,2,ARUMUGAM M,Communist Party of India,58821,628,59449,40.95
Valparai,3,MURUGARAJ M S,Desiya Murpokku Dravida Kazhagam,1327,8,1335,0.92
Valparai,4,KOHILA C,Naam Tamilar Katchi,7588,44,7632,5.26
Valparai,5,SENTHILRAJ D,Makkal Needhi Maiam,3291,23,3314,2.28
Valparai,6,RANGASAMY T M,Independent,353,2,355,0.24
Valparai,7,NOTA,None of the Above,1409,6,1415,0.97
Vandavasi,1,Ambethkumar S,Dravida Munnetra Kazhagam,100951,1113,102064,54.88
Vandavasi,2,Arjunan M,Bahujan Samaj Party,597,10,607,0.33
Vandavasi,3,Suresh S,Makkal Needhi Maiam,1678,14,1692,0.91
Vandavasi,4,Durai B,Ganasangam Party of India,360,3,363,0.2
Vandavasi,5,Prabavathi G,Naam Tamilar Katchi,9249,35,9284,4.99
Vandavasi,6,Murali S,Pattali Makkal Katchi,65617,494,66111,35.55
Vandavasi,7,Venkatesan P,Amma Makkal Munnettra Kazagam,1714,14,1728,0.93
Vandavasi,8,Manikandan K,Independent,1262,2,1264,0.68
Vandavasi,9,Muthuperumal K,Independent,136,3,139,0.07
Vandavasi,10,Murali C,Independent,406,1,407,0.22
Vandavasi,11,Vignesh S,Independent,540,6,546,0.29
Vandavasi,12,NOTA,None of the Above,1759,10,1769,0.95
Vaniyambadi,1,G.SENDHIL KUMAR,All India Anna Dravida Munnetra Kazhagam,87340,678,88018,46.33
Vaniyambadi,2,D.Ramu,Bahujan Samaj Party,715,6,721,0.38
Vaniyambadi,3,R.Sekar,All India Youth Development Party,176,3,179,0.09
Vaniyambadi,4,M.GNANA DOSS,Makkal Needhi Maiam,1843,25,1868,0.98
Vaniyambadi,5,A.J.DEVENDHIRAN,Naam Tamilar Katchi,11151,75,11226,5.91
Vaniyambadi,6,N.MOHAMMED NAYEEM,Indian Union Muslim League,82317,797,83114,43.74
Vaniyambadi,7,T.S.VAKEEL AHMED,All India Majlis-E-Ittehadul Muslimeen,1895,2,1897,1
Vaniyambadi,8,B.JAGAN,Akhil Bharat Hindu Mahasabha,351,5,356,0.19
Vaniyambadi,9,P.ABDUL WAHID,Independent,258,1,259,0.14
Vaniyambadi,10,M.SURESH,Independent,362,0,362,0.19
Vaniyambadi,11,SYED MOHAMMED SALEEM,Independent,131,2,133,0.07
Vaniyambadi,12,DELHI RAJI.S,Independent,184,2,186,0.1
Vaniyambadi,13,C.M.MOHAMMED HUSSAIN,Independent,186,0,186,0.1
Vaniyambadi,14,NOTA,None of the Above,1487,5,1492,0.79
Vanur,1,GANAPATHI P M,Desiya Murpokku Dravida Kazhagam,5430,30,5460,3
Vanur,2,CHAKRAPANI M,All India Anna Dravida Munnetra Kazhagam,91501,718,92219,50.61
Vanur,3,VINAYAGAMURTHY M,Bahujan Samaj Party,765,9,774,0.42
Vanur,4,SANDOSHKUMAR M,Makkal Needhi Maiam,2492,8,2500,1.37
Vanur,5,LATCHOUMY M,Naam Tamilar Katchi,8537,50,8587,4.71
Vanur,6,VANNI ARASU,Viduthalai Chiruthaigal Katchi,69843,649,70492,38.69
Vanur,7,SAKTHIVEL S,Independent,811,2,813,0.45
Vanur,8,NOTA,None of the Above,1356,7,1363,0.75
Vasudevanallur,1,"SADHAN THIRUMALAIKUMAR, DOCTOR.T",Dravida Munnetra Kazhagam,67053,1677,68730,39.08
Vasudevanallur,2,MANOHARAN A,All India Anna Dravida Munnetra Kazhagam,65952,411,66363,37.73
Vasudevanallur,3,ESWARAN M,New Generation People’s Party,789,6,795,0.45
Vasudevanallur,4,KARUPPASAMY K,My India Party,340,2,342,0.19
Vasudevanallur,5,CHINNASAMY M,Makkal Needhi Maiam,2105,34,2139,1.22
Vasudevanallur,6,THANGARAJ S,Amma Makkal Munnettra Kazagam,13194,182,13376,7.61
Vasudevanallur,7,PETCHIAMMAL V,Puthiya Tamilagam,3600,51,3651,2.08
Vasudevanallur,8,MATHIVANAN S S,Naam Tamilar Katchi,16545,186,16731,9.51
Vasudevanallur,9,JAYAKUMAR P L A,Tamil Nadu Ilangyar Katchi,525,19,544,0.31
Vasudevanallur,10,MUTHUPANDI G,Independent,322,1,323,0.18
Vasudevanallur,11,RAMAMOORTHY P,Independent,715,1,716,0.41
Vasudevanallur,12,NOTA,None of the Above,2147,24,2171,1.23
Vedaranyam,1,R.PANNEERSELVAM,Bahujan Samaj Party,460,0,460,0.29
Vedaranyam,2,O.S.MANIAN,All India Anna Dravida Munnetra Kazhagam,77625,1094,78719,49.8
Vedaranyam,3,S.K.VETHARATHINAM,Dravida Munnetra Kazhagam,64823,1567,66390,42
Vedaranyam,4,P.S.ARUMUGAM,Amma Makkal Munnettra Kazagam,1276,8,1284,0.81
Vedaranyam,5,K.RAJENDRAN,Naam Tamilar Katchi,9030,76,9106,5.76
Vedaranyam,6,Dr.T.SUNDARAVADIVELAN,Shiv Sena,91,0,91,0.06
Vedaranyam,7,MOHAMED ALI,Makkal Needhi Maiam,433,4,437,0.28
Vedaranyam,8,R.RAMAMURTHY,Independent,65,0,65,0.04
Vedaranyam,9,T.RAMAJAYAM,Independent,63,13,76,0.05
Vedaranyam,10,R.KATHIRVEL,Independent,139,4,143,0.09
Vedaranyam,11,P.V.THEENATHAYALAN,Independent,315,4,319,0.2
Vedaranyam,12,V.VEERAKUMAR,Independent,297,0,297,0.19
Vedaranyam,13,NOTA,None of the Above,670,3,673,0.43
Vedasandur,1,GANDHIRAJAN S,Dravida Munnetra Kazhagam,105157,1324,106481,49.97
Vedasandur,2,PARAMASIVAM V P B,All India Anna Dravida Munnetra Kazhagam,88330,598,88928,41.73
Vedasandur,3,KARTHIKEYAN A,My India Party,669,0,669,0.31
Vedasandur,4,KALIMUTHU V,Samaniya Makkal Nala Katchi,101,0,101,0.05
Vedasandur,5,POTHUMANI R,Naam Tamilar Katchi,8441,54,8495,3.99
Vedasandur,6,MANEESHANKAR M G,Rashtriya Samaj Paksha,105,3,108,0.05
Vedasandur,7,MURUGESAN K,Ganasangam Party of India,123,0,123,0.06
Vedasandur,8,RAMASAMY P,Amma Makkal Munnettra Kazagam,2030,11,2041,0.96
Vedasandur,9,VETRIVEL S,Makkal Needhi Maiam,1202,13,1215,0.57
Vedasandur,10,SARAVANA KUMAR K R,Independent,71,1,72,0.03
Vedasandur,11,SUKUMAR V,Independent,233,0,233,0.11
Vedasandur,12,SELVARAJ V,Independent,71,0,71,0.03
Vedasandur,13,DHARMALINGAM Dr MARUR N,Independent,78,3,81,0.04
Vedasandur,14,NANDAKUMAR P,Independent,124,0,124,0.06
Vedasandur,15,PALANICHAMY B,Independent,1292,1,1293,0.61
Vedasandur,16,PRASATH R,Independent,886,1,887,0.42
Vedasandur,17,MUTHUSAMY V,Independent,739,1,740,0.35
Vedasandur,18,MURUGAN P,Independent,489,0,489,0.23
Vedasandur,19,MOORTHY S,Independent,77,0,77,0.04
Vedasandur,20,RAMASAMY K,Independent,48,1,49,0.02
Vedasandur,21,NOTA,None of the Above,798,5,803,0.38
Veerapandi,1,"CHINNANANN, M.",Bahujan Samaj Party,358,3,361,0.16
Veerapandi,2,"THARUN, A.K.",Dravida Munnetra Kazhagam,90732,1055,91787,41.03
Veerapandi,3,"RAJAMUTHU, M.",All India Anna Dravida Munnetra Kazhagam,111081,601,111682,49.92
Veerapandi,4,"AMUTHA, R.",Indiya Jananayaka Katchi,1293,9,1302,0.58
Veerapandi,5,SATHIYAVANI,Dhesiya Makkal Kazhagam,117,1,118,0.05
Veerapandi,6,"SELVAM, S.K.",Amma Makkal Munnettra Kazagam,4957,29,4986,2.23
Veerapandi,7,"PRABAKARAN, P.",Veerath Thiyagi Viswanathadoss Thozhilalarkal Katchi,67,2,69,0.03
Veerapandi,8,"MANI, M.",My India Party,133,0,133,0.06
Veerapandi,9,"MANIKANDAN, S.",All India Jananayaka Makkal Kazhagam,59,0,59,0.03
Veerapandi,10,"MOHAN, P.",SOCIALIST UNITY CENTRE OF INDIA (COMMUNIST),126,3,129,0.06
Veerapandi,11,"RAJESHKUMAR, S.",Naam Tamilar Katchi,9734,72,9806,4.38
Veerapandi,12,INDRAJITH GUPTHA,Independent,229,1,230,0.1
Veerapandi,13,"SENTHILKUMAR, J.",Independent,94,0,94,0.04
Veerapandi,14,"SENTHILMURUGAN, E.",Independent,265,0,265,0.12
Veerapandi,15,"SEKAR, M.",Independent,208,0,208,0.09
Veerapandi,16,"MOHAN, V.",Independent,384,2,386,0.17
Veerapandi,17,"RAMESH, C.",Independent,55,0,55,0.02
Veerapandi,18,"RAJARATHINAM, K.",Independent,236,1,237,0.11
Veerapandi,19,"VENKAT, A.",Independent,324,0,324,0.14
Veerapandi,20,"VAITHI, M.",Independent,62,0,62,0.03
Veerapandi,21,NOTA,None of the Above,1391,18,1409,0.63
Velachery,1,JMH.AASSAN MAULAANA,Indian National Congress,67998,495,68493,38.76
Velachery,2,M.K.ASHOK,All India Anna Dravida Munnetra Kazhagam,63830,311,64141,36.3
Velachery,3,C.VELU,Bahujan Samaj Party,473,4,477,0.27
Velachery,4,R.KANCHANA,Tamizhaga Murpokku Makkal Katchi,86,1,87,0.05
Velachery,5,GEETHA,New Generation People’s Party,277,1,278,0.16
Velachery,6,M.KEERTHANA,Naam Tamilar Katchi,14142,29,14171,8.02
Velachery,7,M.CHANDRABOSE,Amma Makkal Munnettra Kazagam,1972,5,1977,1.12
Velachery,8,A.CHANDRAN,MGR Makkal Katchi,85,0,85,0.05
Velachery,9,Dr. SANTHOSH BABU IAS (Retd),Makkal Needhi Maiam,22992,80,23072,13.06
Velachery,10,V.L.REVATHI JAYAKUMARI,Tamil Nadu Ilangyar Katchi,746,4,750,0.42
Velachery,11,J.VICTOR PAUL,Republican Party of India (Athawale),69,0,69,0.04
Velachery,12,D.VENKATESHAN,Anaithu Makkal Arasiyal Katchi,63,0,63,0.04
Velachery,13,G.YESUDASAN,Independent,48,0,48,0.03
Velachery,14,K.KANNAN,Independent,57,0,57,0.03
Velachery,15,S.GOKUL,Independent,89,0,89,0.05
Velachery,16,V.SIVARAMAN,Independent,282,0,282,0.16
Velachery,17,A.TAMIL AZHAGAN,Independent,229,0,229,0.13
Velachery,18,N.MAHALAKSHMI,Independent,143,0,143,0.08
Velachery,19,MURALI BALAJI,Independent,116,0,116,0.07
Velachery,20,M.VIGNESH,Independent,34,0,34,0.02
Velachery,21,A.VETRISELVAN,Independent,24,0,24,0.01
Velachery,22,S.JOTHI KANNAN,Independent,116,1,117,0.07
Velachery,23,V.HARIHARAN,Independent,170,0,170,0.1
Velachery,24,NOTA,None of the Above,1725,17,1742,0.99
Vellore,1,Appu S.R.K,All India Anna Dravida Munnetra Kazhagam,74457,661,75118,41.76
Vellore,2,Karthikeyan .P,Dravida Munnetra Kazhagam,82907,1392,84299,46.86
Vellore,3,Senthilkumar .P,Veerath Thiyagi Viswanathadoss Thozhilalarkal Katchi,200,2,202,0.11
Vellore,4,Syed Jalaluddin .M,Tipu Sultan Party,186,1,187,0.1
Vellore,5,Dharmalingam .V.D,Amma Makkal Munnettra Kazagam,860,5,865,0.48
Vellore,6,Naresh Kumar .R,Tamil Nadu Ilangyar Katchi,921,7,928,0.52
Vellore,7,Poonkundran .N,Naam Tamilar Katchi,8454,76,8530,4.74
Vellore,8,Manogaran S,Kamarajar Deseeya Congress,67,0,67,0.04
Vellore,9,Vikram Chakravarthy .G,Makkal Needhi Maiam,7179,64,7243,4.03
Vellore,10,Karthick .E,Independent,35,1,36,0.02
Vellore,11,Karthikeyan .R,Independent,40,2,42,0.02
Vellore,12,Sathishkumar .S,Independent,54,0,54,0.03
Vellore,13,Srinivasan .N,Independent,67,0,67,0.04
Vellore,14,Naseer K,Independent,90,1,91,0.05
Vellore,15,Panneer Sevlan .N,Independent,135,3,138,0.08
Vellore,16,Vijayaraj .K,Independent,224,0,224,0.12
Vellore,17,Vishnumohan .E,Independent,364,3,367,0.2
Vellore,18,NOTA,None of the Above,1417,24,1441,0.8
Veppanahalli,1,P.Murugan,Dravida Munnetra Kazhagam,90593,457,91050,44.38
Veppanahalli,2,S.M.Murugesan,Desiya Murpokku Dravida Kazhagam,3592,9,3601,1.76
Veppanahalli,3,K.P.Munusamy,All India Anna Dravida Munnetra Kazhagam,93855,249,94104,45.87
Veppanahalli,4,M.Sakthivel,Naam Tamilar Katchi,8287,23,8310,4.05
Veppanahalli,5,S.Thangapandiyan,Tamil Nadu Ilangyar Katchi,416,3,419,0.2
Veppanahalli,6,M.Mariyappan,Puthiya Tamilagam,225,1,226,0.11
Veppanahalli,7,Valli,Anna Puratchi Thalaivar Amma Dravida Munnetra Kazhagam,124,7,131,0.06
Veppanahalli,8,P.Jayapal,Makkal Needhi Maiam,667,5,672,0.33
Veppanahalli,9,Abdul Azeez Amanullah,Independent,3015,7,3022,1.47
Veppanahalli,10,Usha,Independent,146,8,154,0.08
Veppanahalli,11,Krishnamoorthy,Independent,154,1,155,0.08
Veppanahalli,12,C.Chakkarlappa,Independent,403,2,405,0.2
Veppanahalli,13,K.P.U.UVARAJ,Independent,285,0,285,0.14
Veppanahalli,14,Ramaswamy,Independent,565,2,567,0.28
Veppanahalli,15,Lakshmanan Shanmugam,Independent,376,2,378,0.18
Veppanahalli,16,NOTA,None of the Above,1661,1,1662,0.81
Vikravandi,1,ARUMUGAM C,Bahujan Samaj Party,517,3,520,0.27
Vikravandi,2,PUGAZHENTHI N,Dravida Munnetra Kazhagam,92621,1109,93730,48.41
Vikravandi,3,MUTHAMILSELVAN R,All India Anna Dravida Munnetra Kazhagam,83258,899,84157,43.47
Vikravandi,4,ELANGOVAN S,Akhil Bharat Hindu Mahasabha,652,3,655,0.34
Vikravandi,5,IYYANAR R,Amma Makkal Munnettra Kazagam,3039,14,3053,1.58
Vikravandi,6,SENTHIL R,Indiya Jananayaka Katchi,204,3,207,0.11
Vikravandi,7,RAJIVGANDHI P,Naadaalum Makkal Katchi,95,1,96,0.05
Vikravandi,8,SHEEBA ASHMI R,Naam Tamilar Katchi,8141,75,8216,4.24
Vikravandi,9,IYYAPPAN K,Independent,54,0,54,0.03
Vikravandi,10,AYYANAR A,Independent,75,3,78,0.04
Vikravandi,11,KANNADHASAN A,Independent,73,8,81,0.04
Vikravandi,12,GAYATHRI J,Independent,303,2,305,0.16
Vikravandi,13,SATHISH R,Independent,436,0,436,0.23
Vikravandi,14,RAGHUPATHY P,Independent,906,1,907,0.47
Vikravandi,15,NOTA,None of the Above,1108,14,1122,0.58
Vilathikulam,1,CHINNAPPAN P,All India Anna Dravida Munnetra Kazhagam,51237,562,51799,30.99
Vilathikulam,2,MANIKKARAJ A,Bahujan Samaj Party,480,7,487,0.29
Vilathikulam,3,MARKANDAYAN V,Dravida Munnetra Kazhagam,89130,1218,90348,54.05
Vilathikulam,4,KARUPPASAMY K,Naam Indiar Party,610,3,613,0.37
Vilathikulam,5,GANDHI M,Bahujan Dravida Party,119,2,121,0.07
Vilathikulam,6,SEENI SELVI K,Amma Makkal Munnettra Kazagam,6591,66,6657,3.98
Vilathikulam,7,BALAJI R,Naam Tamilar Katchi,11697,131,11828,7.08
Vilathikulam,8,MARIMUTHU S,South India Forward Bloc,398,6,404,0.24
Vilathikulam,9,MUTHUKUMAR C,Puthiya Tamilagam,1029,26,1055,0.63
Vilathikulam,10,WILSON X,Makkal Needhi Maiam,1511,9,1520,0.91
Vilathikulam,11,ARUMUGAPERUMAL K,Independent,263,5,268,0.16
Vilathikulam,12,ARUMUGAM S,Independent,272,0,272,0.16
Vilathikulam,13,CHELLADURAI S,Independent,310,2,312,0.19
Vilathikulam,14,MURUGANANTHAM M,Independent,347,1,348,0.21
Vilathikulam,15,RAJAMANI P,Independent,101,0,101,0.06
Vilathikulam,16,NOTA,None of the Above,1017,19,1036,0.62
Vilavancode,1,IDEN SONI L,Desiya Murpokku Dravida Kazhagam,2415,32,2447,1.46
Vilavancode,2,VIJAYADHARANI S,Indian National Congress,86227,1246,87473,52.12
Vilavancode,3,JAYASEELAN R,Bharatiya Janata Party,58156,648,58804,35.04
Vilavancode,4,MARY ADLIN,Naam Tamilar Katchi,12120,172,12292,7.32
Vilavancode,5,RAJAKUMAR R,Makkal Needhi Maiam,626,11,637,0.38
Vilavancode,6,RAJESH KUMAR S,National Democratic Party of South India,77,2,79,0.05
Vilavancode,7,VASANTHEESWARAN E,Ulaga Makkal Katchi,234,1,235,0.14
Vilavancode,8,WILSON G,Shiv Sena,161,0,161,0.1
Vilavancode,9,AMOSE S,Independent,431,5,436,0.26
Vilavancode,10,SATHEESH S,Independent,183,2,185,0.11
Vilavancode,11,SAMUEL GEORGE KALAI ARASAR,Independent,3492,49,3541,2.11
Vilavancode,12,MARIASELVAN Y,Independent,122,0,122,0.07
Vilavancode,13,MOHAN KUMAR M,Independent,198,0,198,0.12
Vilavancode,14,RAJA MURRUGAN K H,Independent,150,0,150,0.09
Vilavancode,15,VIJAYAKUMAR P,Independent,293,1,294,0.18
Vilavancode,16,NOTA,None of the Above,774,8,782,0.47
Villivakkam,1,D.Subamangalam,Desiya Murpokku Dravida Kazhagam,1081,13,1094,0.76
Villivakkam,2,A.Palanivel,Bahujan Samaj Party,221,1,222,0.15
Villivakkam,3,J.C.D.Prabhakar,All India Anna Dravida Munnetra Kazhagam,38601,289,38890,26.99
Villivakkam,4,A . Vetriazhagan,Dravida Munnetra Kazhagam,75347,780,76127,52.83
Villivakkam,5,L.Govindaraj,Nam India Naam Indiyar Katchi,188,1,189,0.13
Villivakkam,6,S. Raju Bharathi,Desiya Makkal Sakthi Katchi,88,0,88,0.06
Villivakkam,7,Jagadesh Jayakumar,Valamaana  Tamizhagam   Katchi,261,0,261,0.18
Villivakkam,8,R.Sridar,Naam Tamilar Katchi,10846,68,10914,7.57
Villivakkam,9,Sriharan,Makkal Needhi Maiam,13282,82,13364,9.27
Villivakkam,10,C.A.Ashok Kumar,Independent,39,1,40,0.03
Villivakkam,11,A . Ajith Kumar,Independent,80,0,80,0.06
Villivakkam,12,G.Iyanar,Independent,34,2,36,0.02
Villivakkam,13,S.Kandasamy,Independent,68,6,74,0.05
Villivakkam,14,M.Gunasekaran,Independent,206,0,206,0.14
Villivakkam,15,A.S.Kumar,Independent,42,0,42,0.03
Villivakkam,16,S.Chandrika,Independent,193,1,194,0.13
Villivakkam,17,Syed Rayhan,Independent,409,0,409,0.28
Villivakkam,18,G. Devapriyan,Independent,27,0,27,0.02
Villivakkam,19,S.Baskar,Independent,171,0,171,0.12
Villivakkam,20,M.Murali Vinodh,Independent,98,0,98,0.07
Villivakkam,21,C.Mohan,Independent,54,0,54,0.04
Villivakkam,22,C.Raghul,Independent,24,1,25,0.02
Villivakkam,23,M .Jalal,Independent,43,0,43,0.03
Villivakkam,24,NOTA,None of the Above,1430,14,1444,1
Villupuram,1,LAKSHMANAN R,Dravida Munnetra Kazhagam,100423,1848,102271,49.92
Villupuram,2,SHANMUGAM C Ve,All India Anna Dravida Munnetra Kazhagam,86368,1035,87403,42.66
Villupuram,3,SIVABALAN N,Bahujan Samaj Party,412,3,415,0.2
Villupuram,4,SELVAM J,Naam Tamilar Katchi,6314,61,6375,3.11
Villupuram,5,DASS K,Makkal Needhi Maiam,3207,35,3242,1.58
Villupuram,6,DURAISAMY D,Makkal Munnetra Peravai,318,4,322,0.16
Villupuram,7,DEVANATHAN N,Veerath Thiyagi Viswanathadoss Thozhilalarkal Katchi,118,0,118,0.06
Villupuram,8,BALASUNDARAM R,Amma Makkal Munnettra Kazagam,1684,11,1695,0.83
Villupuram,9,MOHAMED IBRAIM A,Anna Dravidar Kazhagam,32,0,32,0.02
Villupuram,10,VICTOR A S,Desiya Sirupanmayinar Makkal Iyakkam,78,0,78,0.04
Villupuram,11,INIYADAYALAN G,Independent,19,0,19,0.01
Villupuram,12,IYYANAR G,Independent,34,0,34,0.02
Villupuram,13,KUPPAN V,Independent,67,0,67,0.03
Villupuram,14,KUMAR R,Independent,66,0,66,0.03
Villupuram,15,KESAVAN P,Independent,321,0,321,0.16
Villupuram,16,SHANMUGAM A,Independent,491,0,491,0.24
Villupuram,17,SHANMUGAM G,Independent,371,0,371,0.18
Villupuram,18,SHANMUGAM V,Independent,233,0,233,0.11
Villupuram,19,SUBRAMANIAN R,Independent,25,2,27,0.01
Villupuram,20,DAKSHINAMOORTHY SU VA,Independent,47,1,48,0.02
Villupuram,21,NARENDIRAN D,Independent,23,0,23,0.01
Villupuram,22,BALU K,Independent,42,0,42,0.02
Villupuram,23,PRABAKARAN M,Independent,35,0,35,0.02
Villupuram,24,RAMAN K,Independent,78,0,78,0.04
Villupuram,25,JAIAADHE R,Independent,84,0,84,0.04
Villupuram,26,NOTA,None of the Above,960,10,970,0.47
Viralimalai,1,ALAGURAJA.V,Bahujan Samaj Party,263,0,263,0.14
Viralimalai,2,PALANIAPPAN,Dravida Munnetra Kazhagam,78028,553,78581,40.63
Viralimalai,3,VIJAYA BASKER C,All India Anna Dravida Munnetra Kazhagam,101676,503,102179,52.83
Viralimalai,4,AZHAGU MEENA P,Naam Tamilar Katchi,7013,22,7035,3.64
Viralimalai,5,ARUMUGAM P,Puthiya Tamilagam,213,2,215,0.11
Viralimalai,6,KARTHI PRABHAKARAN O,Amma Makkal Munnettra Kazagam,1220,8,1228,0.63
Viralimalai,7,SARAVANAN R,Makkal Needhi Maiam,559,0,559,0.29
Viralimalai,8,SENTHILKUMAR P,My India Party,35,0,35,0.02
Viralimalai,9,VIJAY A,Anna Dravidar Kazhagam,26,0,26,0.01
Viralimalai,10,ABDUL NAZAR K,Independent,33,0,33,0.02
Viralimalai,11,ELAYARAJA R,Independent,37,0,37,0.02
Viralimalai,12,SYEED MOHAMED J,Independent,50,0,50,0.03
Viralimalai,13,DHANALAKSHMI.M,Independent,618,2,620,0.32
Viralimalai,14,THIRUVENTHIRAN V,Independent,508,1,509,0.26
Viralimalai,15,PALANISAMY A,Independent,239,2,241,0.12
Viralimalai,16,BALASUBRAMANIAN M,Independent,156,0,156,0.08
Viralimalai,17,MANIKANDAN K,Independent,73,0,73,0.04
Viralimalai,18,MANIKANDAN. C,Independent,291,0,291,0.15
Viralimalai,19,RAMESH M,Independent,504,0,504,0.26
Viralimalai,20,RAMESHKUMAR.P,Independent,93,0,93,0.05
Viralimalai,21,RAJAVARMAN R,Independent,119,0,119,0.06
Viralimalai,22,JOTHIVEL A,Independent,191,0,191,0.1
Viralimalai,23,NOTA,None of the Above,385,0,385,0.2
Virudhunagar,1,SEENIVASAN A.R.R,Dravida Munnetra Kazhagam,71909,1388,73297,45.32
Virudhunagar,2,PANDURANGAN G,Bharatiya Janata Party,51502,456,51958,32.13
Virudhunagar,3,SUYAMBULINGAM L,Naam Indiar Party,587,3,590,0.36
Virudhunagar,4,SELVAKUMAR V.R,Naam Tamilar Katchi,14162,149,14311,8.85
Virudhunagar,5,THANGARAJ M,Amma Makkal Munnettra Kazagam,10642,141,10783,6.67
Virudhunagar,6,MANIMARAN N,All India Samathuva Makhal Katchi,4996,58,5054,3.13
Virudhunagar,7,VIKRAMAN N,Desa Makkal Munnetrak Kazhgam,200,0,200,0.12
Virudhunagar,8,KARUPPIAH P,Independent,84,1,85,0.05
Virudhunagar,9,GUNASEKARAN G,Independent,1377,29,1406,0.87
Virudhunagar,10,GURUNATHAN G,Independent,64,0,64,0.04
Virudhunagar,11,SHIBI B,Independent,261,3,264,0.16
Virudhunagar,12,THANGAPANDI N,Independent,85,4,89,0.06
Virudhunagar,13,THANGARAJ R,Independent,93,0,93,0.06
Virudhunagar,14,DHAMOTHARAN R,Independent,119,0,119,0.07
Virudhunagar,15,PANDURENGAN T,Independent,279,3,282,0.17
Virudhunagar,16,PUNGAN K,Independent,758,1,759,0.47
Virudhunagar,17,RAMARAJ C,Independent,463,2,465,0.29
Virudhunagar,18,VELUCHAMY S,Independent,328,0,328,0.2
Virudhunagar,19,NOTA,None of the Above,1556,14,1570,0.97
Virugampakkam,1,B.PARTHASARATHY,Desiya Murpokku Dravida Kazhagam,1584,1,1585,0.94
Virugampakkam,2,AMV.PRABHAKARA RAJA,Dravida Munnetra Kazhagam,73814,537,74351,43.97
Virugampakkam,3,VIRUGAI V.N.RAVI,All India Anna Dravida Munnetra Kazhagam,55526,458,55984,33.11
Virugampakkam,4,M.S.ISMAIL KHAN,All India Jananayaka Makkal Kazhagam,206,3,209,0.12
Virugampakkam,5,SENEGAN,Makkal Needhi Maiam,16871,68,16939,10.02
Virugampakkam,6,G.THANIGACHALAM,Veerath Thiyagi Viswanathadoss Thozhilalarkal Katchi,90,0,90,0.05
Virugampakkam,7,S.R.DINESH KUMAR,Anna MGR Dravida Makkal Kalgam,40,1,41,0.02
Virugampakkam,8,R.PRABAHARAN,Tamizhaga Murpokku Makkal Katchi,63,2,65,0.04
Virugampakkam,9,MANJU,Anaithu Makkal Arasiyal Katchi,89,1,90,0.05
Virugampakkam,10,G.RAVI,Rashtriya Janata Dal,69,4,73,0.04
Virugampakkam,11,T.S.RAJENDRAN,Naam Tamilar Katchi,10153,32,10185,6.02
Virugampakkam,12,M.ELLANGOVAN,Independent,68,4,72,0.04
Virugampakkam,13,V.K.KATHIR,Independent,48,0,48,0.03
Virugampakkam,14,S.GUNASEKAR,Independent,86,2,88,0.05
Virugampakkam,15,M.GUNASEKARAN (A) STAR M.GUNASEKARAN,Independent,5165,21,5186,3.07
Virugampakkam,16,V.GUNASEKARAN,Independent,131,0,131,0.08
Virugampakkam,17,E.SANKAR,Independent,68,0,68,0.04
Virugampakkam,18,SATHASIVAM,Independent,344,0,344,0.2
Virugampakkam,19,M.SIVAKUMAR,Independent,119,0,119,0.07
Virugampakkam,20,M.SRINIVASAN,Independent,49,0,49,0.03
Virugampakkam,21,D.SUNDAR SINGH,Independent,56,0,56,0.03
Virugampakkam,22,V.K.SENTHIL KUMAR,Independent,24,0,24,0.01
Virugampakkam,23,V.THALAPATHI,Independent,49,0,49,0.03
Virugampakkam,24,D.PRABAKARAN,Independent,55,1,56,0.03
Virugampakkam,25,K.BOOPATHY,Independent,34,0,34,0.02
Virugampakkam,26,M.MANNU,Independent,146,2,148,0.09
Virugampakkam,27,R.MAYILSAMY,Independent,1436,4,1440,0.85
Virugampakkam,28,NOTA,None of the Above,1551,12,1563,0.92
Vriddhachalam,1,A. Ayyasamy,Bahujan Samaj Party,461,7,468,0.24
Vriddhachalam,2,Premalatha Vijayakant,Desiya Murpokku Dravida Kazhagam,25790,118,25908,13.17
Vriddhachalam,3,Radhakrishnan,Indian National Congress,75892,1172,77064,39.17
Vriddhachalam,4,N. Amutha,Naam Tamilar Katchi,8603,39,8642,4.39
Vriddhachalam,5,B. Arasi,Rashtriya Janata Dal,404,1,405,0.21
Vriddhachalam,6,Karthikeyan. J,Pattali Makkal Katchi,75585,617,76202,38.73
Vriddhachalam,7,R. Kesavaperumal,Tamil Nadu Ilangyar Katchi,887,4,891,0.45
Vriddhachalam,8,Sathiyanathan,Anaithu Makkal Puratchi Katchi,272,1,273,0.14
Vriddhachalam,9,Sivasankar,New Generation People’s Party,178,1,179,0.09
Vriddhachalam,10,R. Parthasarathi,Indiya Jananayaka Katchi,822,19,841,0.43
Vriddhachalam,11,G. Pichamuthu,Desiya Sirupanmayinar Makkal Iyakkam,323,0,323,0.16
Vriddhachalam,12,S. Aruljothi,Independent,86,0,86,0.04
Vriddhachalam,13,M. Anwar Basha,Independent,298,2,300,0.15
Vriddhachalam,14,S. Sadhasivam,Independent,245,1,246,0.13
Vriddhachalam,15,M. Sathiyaseelan,Independent,261,0,261,0.13
Vriddhachalam,16,R. Saravanan,Independent,398,0,398,0.2
Vriddhachalam,17,K.P.Senthilmurugan,Independent,270,0,270,0.14
Vriddhachalam,18,C. Dhanasekar,Independent,268,0,268,0.14
Vriddhachalam,19,Perumal,Independent,485,0,485,0.25
Vriddhachalam,20,S. Mahaveer Chand,Independent,175,0,175,0.09
Vriddhachalam,21,A. Manikandan,Independent,108,1,109,0.06
Vriddhachalam,22,S. Muruganantham,Independent,526,1,527,0.27
Vriddhachalam,23,S. Radhakrishnan,Independent,101,2,103,0.05
Vriddhachalam,24,N. Radhika,Independent,193,1,194,0.1
Vriddhachalam,25,P. Ramasamy,Independent,74,0,74,0.04
Vriddhachalam,26,Ramadoss  S,Independent,114,1,115,0.06
Vriddhachalam,27,K. Ravichandiran,Independent,156,0,156,0.08
Vriddhachalam,28,T. Veeramani,Independent,148,0,148,0.08
Vriddhachalam,29,Stalin,Independent,859,3,862,0.44
Vriddhachalam,30,NOTA,None of the Above,757,4,761,0.39
Yercaud,1,C. KUMAR,Desiya Murpokku Dravida Kazhagam,2962,24,2986,1.25
Yercaud,2,G. Chitra,All India Anna Dravida Munnetra Kazhagam,120542,1019,121561,50.88
Yercaud,3,C. TAMILSELVAN,Dravida Munnetra Kazhagam,93927,1679,95606,40.02
Yercaud,4,P. Ramasamy,Bahujan Samaj Party,579,0,579,0.24
Yercaud,5,T. Duraisamy,Indiya Jananayaka Katchi,870,6,876,0.37
Yercaud,6,Jothi,Naam Tamilar Katchi,13214,94,13308,5.57
Yercaud,7,S.T. Rajendhiran,Independent,158,7,165,0.07
Yercaud,8,K. UNNAMALAI,Independent,109,1,110,0.05
Yercaud,9,P. SATHISHKUMAR,Independent,148,0,148,0.06
Yercaud,10,Santhosam,Independent,165,2,167,0.07
Yercaud,11,T. Priya,Independent,284,5,289,0.12
Yercaud,12,K. Manikandan,Independent,485,5,490,0.21
Yercaud,13,D. MADESH,Independent,659,1,660,0.28
Yercaud,14,NOTA,None of the Above,1955,24,1979,0.83
